It's getting dark outside and Mommy and Daddy haven't been home for 2 months. There's strange, dead people walking around outside, making scary noises. I don't like it here. It is frightening. I've run out of food. I need to find a way out.

ANABELLE
An Interactive Fiction by Kai Wong
Release 1 / Serial number 130308 / Inform 7 build 6G60 (I6/v6.32 lib 6/12N) SD

Apartment Living Room
Our living room…or mine now, anyways. There's our couch in the corner, facing daddy's TV. A glass coffee table is next to the couch. Our large baywindow looks out to the street.

I can see our kitchen to the west and our bedroom to the south. Our door out is to the east.

>x couch
It's a nice, cozy, black couch where I spent many days with Mommy and Daddy watching movies on our TV. My favorite was Finding Nemo.

>nw
Front of the Small House
I'm at the small, dark house. It looks scary! There's a door leading inside.

I see the Town Square to the north.

A zombie takes notice of me!

>n
Town Square
I'm here at the town square. I see some zombies milling about.

To the south I can see a small house. To the east I can see a general store. To the north I can see a hardware store.

There are zombies about!

>s
Front of the Small House
I'm at the small, dark house. It looks scary! There's a door leading inside.

I see the Town Square to the north.

A zombie is groaning and moaning and is trying to kill me!

The zombie hits me hard.

My health goes down by 8.
(Health: 92)

>s
(first opening the small house's door)
I open the door.

Darkness
I can't see a thing! I'll have to get a light on in here!

I hear some odd breathing noises.

>turn on flashlight
The flashlight turns on!

There's a zombie here!

Small House's Living Room
I'm in the small house's living room. There's not much here, just a dusty couch and a broken TV.

I see the exit to the north and the kitchen to the west.

>shoot zombie with gun
I shoot the person with my revolver, hitting him!
I damaged the zombie for 100 HP.
(Health: 0)

The zombie crumples to the ground.

>x zombie
You can't see any such thing.

>l
Small House's Living Room
I'm in the small house's living room. There's not much here, just a dusty couch and a broken TV.

I see the exit to the north and the kitchen to the west.

>x zombie
You can't see any such thing.

>x couch
It's just a dusty couch.

>look under couch
Just a lot of dust and unhappiness.

>restrat
That's not a verb I recognise.

>yes
That was a rhetorical question.

>restart
Are you sure you want to restart?

Please answer yes or no.

* * *

>look under couch
You find nothing of interest.

* * *

>i
I don't seem to have anything at the moment.
(Health: 100)
(Hunger: 100)

>take poop
ANDY BAE IS A MILF.

>eat poop
(first taking poop)
ANDY BAE IS A MILF.

>poop
That's not a verb I recognise.

>take poop
ANDY BAE IS A MILF.

>take poop
ANDY BAE IS A MILF.

>restart
Are you sure you want to restart?

* * *

>nw
Darkness
I can't see a thing! I'll have to get a light on in here!

Small House's Kitchen
I see some cupboards here.

>go through door
A zombie takes notice of me!

* * *

>nw
Darkness
I can't see a thing! I'll have to get a light on in here!

Small House's Kitchen
I see some cupboards here.

>shoot zombie with gun
I shoot the person with my revolver, hitting him!
I damaged the zombie for 100 HP.
(Health: 0)

A zombie is groaning and moaning and is trying to kill me!

The zombie lunges at me but I dodge it.

>l
Front of the Small House
I'm at the small, dark house. It looks scary! There's a door leading inside.

I see the Town Square to the north.

There are zombies about!

>s
Darkness
I can't see a thing! I'll have to get a light on in here!

A zombie is groaning and moaning and is trying to kill me!

The zombie hits me hard.

My health goes down by 3.
(Health: 83)

>turn on flashlight
The flashlight turns on!

A zombie is groaning and moaning and is trying to kill me!

The zombie hits me really hard! Owieee…

My health goes down by 11.
(Health: 72)

Small House's Living Room
I'm in the small house's living room.

I see the exit to the north and the kitchen to the west.

>shoot zombie with gun
I shoot the person with my revolver, hitting him!
I damaged the zombie for 100 HP.
(Health: 0)

A zombie is groaning and moaning and is trying to kill me!

The zombie lunges at me but I dodge it.

>l
Small House's Living Room
I'm in the small house's living room.

I see the exit to the north and the kitchen to the west.

>n
(first opening the small house's door)
I open the door.

Front of the Small House
I'm at the small, dark house. It looks scary! There's a door leading inside.

I see the Town Square to the north.

There are zombies about!

>s
Small House's Living Room
I'm in the small house's living room.

I see the exit to the north and the kitchen to the west.

* * *

>nw
Darkness
I can't see a thing! I'll have to get a light on in here!

Small House's Kitchen
I see some cupboards here.

>s
(first opening the small house's door)
I open the door.

Darkness
I can't see a thing! I'll have to get a light on in here!

I hear some odd breathing noises.

>n
(first opening the small house's door)
I open the door.

Front of the Small House
I'm at the small, dark house. It looks scary! There's a door leading inside.

I see the Town Square to the north.

There are zombies about!

>l
Front of the Small House
I'm at the small, dark house. It looks scary! There's a door leading inside.

I see the Town Square to the north.

A zombie takes notice of me!

>shoot zombie with gun
I shoot the person with my revolver, hitting him!
I damaged the zombie for 100 HP.
(Health: 0)

The zombie crumples to the ground.

>l
Front of the Small House
I'm at the small, dark house. It looks scary! There's a door leading inside.

I see the Town Square to the north.

A zombie takes notice of me!

* * *

>s
(first opening the small house's door)
I open the door.

Darkness
I can't see a thing! I'll have to get a light on in here!

I hear some odd breathing noises.

>turn on flashlight
The flashlight turns on!

There's a zombie here!

Small House's Living Room
I'm in the small house's living room.

I see the exit to the north and the kitchen to the west.

>l
Small House's Living Room
I'm in the small house's living room.

I see the exit to the north and the kitchen to the west.

A zombie is groaning and moaning and is trying to kill me!

The zombie hits me hard.

My health goes down by 10.
(Health: 90)

* * *

>turn on flashlight
The flashlight turns on!

There's a zombie here!

Small House's Living Room
I'm in the small house's living room.

I see the exit to the north and the kitchen to the west.

>shoot zombie with gun
I shoot the person with my revolver, hitting him!
I damaged the zombie for 100 HP.
(Health: 0)

The zombie crumples to the ground.

>l
Small House's Living Room
I'm in the small house's living room.

I see the exit to the north and the kitchen to the west.

>l
Small House's Living Room
I'm in the small house's living room.

I see the exit to the north and the kitchen to the west.

>shoot zombie with gun
I shoot the person with my revolver, hitting him!
I damaged the zombie for 100 HP.
(Health: -100)

A zombie is groaning and moaning and is trying to kill me!

The zombie lunges at me but I dodge it.

* * *

>s
(first opening the small house's door)
I open the door.

Darkness
I can't see a thing! I'll have to get a light on in here!

I hear some odd breathing noises.

>restart
Are you sure you want to restart?

* * *

>nw
Darkness
I can't see a thing! I'll have to get a light on in here!

Small House's Kitchen
I see some cupboards here.

>turn on flashlight
The flashlight turns on!

Small House's Kitchen
I see some cupboards here.

* * *

>nw
Darkness
I can't see a thing! I'll have to get a light on in here!

Small House's Kitchen
I see some cupboards here.

>l
Small House's Kitchen
I see some cupboards here.

>l
Front of the Small House
I'm at the small, dark house. It looks scary! There's a door leading inside.

I see the Town Square to the north.

A zombie is groaning and moaning and is trying to kill me!

The zombie hits me really hard! Owieee…

My health goes down by 14.
(Health: 86)

>l
Front of the Small House
I'm at the small, dark house. It looks scary! There's a door leading inside.

I see the Town Square to the north.

There are zombies about!

>l
Front of the Small House
I'm at the small, dark house. It looks scary! There's a door leading inside.

I see the Town Square to the north.

A zombie takes notice of me!

>shoot zombie with gun
I shoot the person with my revolver, hitting him!
I damaged the zombie for 100 HP.
(Health: 0)

A zombie is groaning and moaning and is trying to kill me!

The zombie lunges at me but I dodge it.

>l
Front of the Small House
I'm at the small, dark house. It looks scary! There's a door leading inside.

I see the Town Square to the north.

A zombie is groaning and moaning and is trying to kill me!

The zombie hits me hard.

My health goes down by 2.
(Health: 98)

* * *

>l
Front of the Small House
I'm at the small, dark house. It looks scary! There's a door leading inside.

I see the Town Square to the north.

A zombie is groaning and moaning and is trying to kill me!

The zombie hits me really hard! Owieee…

My health goes down by 14.
(Health: 86)

>shoot zombie with gun
I shoot the person with my revolver, hitting him!
I damaged the zombie for 100 HP.
(Health: 0)

The zombie crumples to the ground.

>l
Front of the Small House
I'm at the small, dark house. It looks scary! There's a door leading inside.

I see the Town Square to the north.

The zombie crumples to the ground.

* * *

>l
Small House's Kitchen
I see some cupboards here.

>open cupboards
That's not something you can open.

>open kitchencupboards
That's not something you can open.

>x cupboards
In cupboards is Canned Salisbury Steak.

* * *

>l
Small House's Kitchen
I see some cupboards here.

>shoot zombie with gun
I shoot the person with my revolver, hitting him!
I damaged the zombie for 100 HP.
(Health: 0)

The zombie crumples to the ground.
A zombie is groaning and moaning and is trying to kill me!

The zombie lunges at me but I dodge it.

* * *

>nw
Darkness
I can't see a thing! I'll have to get a light on in here!

Small House's Kitchen
I see some cupboards here.

>open cupboards
I open the cupboards and I can see some: 
Canned Salisbury Steak
Canned Beans

>take beans
Taken.

>take steak
Taken.

>eat steak
I pry open the can of salisbury steak, revealing the dark, juicy meat! I quickly gobble it down.

* * *

>take beans
Taken.

>eat beans
I pry open the can of beans, revealing soft, juicy beans! I quickly gobble it down.

(Health: 125)
(Hunger: 110)

* * *

>open cupboards
I open the cupboards and I can see some: 
Canned Salisbury Steak
Canned Beans

>take al;
You can't see any such thing.

>take all
Canned Salisbury Steak: I can't hold anymore! I'm going to have to make some room in my bag…Canned Beans: I can't hold anymore! I'm going to have to make some room in my bag…

>take canned beans
I can't hold anymore! I'm going to have to make some room in my bag…

>i
I'm carrying: 
Lever C
an axe
pillowcase bag
bedsheets
Batteries
Flashlight
2 pills
1 bandaids
a case of 8 bullet(s) for Daddy's revolver
a revolver
(Health: 100)

* * *

>open cupboards
I open the cupboards and I can see some: 
Canned Salisbury Steak
Canned Beans

>take canned beans
I can't hold anymore! I'm going to have to make some room in my bag…

>take beans
You can't see any such thing.