It's getting dark outside and Mommy and Daddy haven't been home for 2 months. There are strange, dead people walking around outside, making scary noises. I don't like it here. It is frightening. I've run out of food. I need to find a way out.

For help, type "Commands List".

ANABELLE
An Interactive Fiction by Kai Wong
Release 1 / Serial number 130314 / Inform 7 build 6G60 (I6/v6.32 lib 6/12N) SD

Apartment Living Room
Our living room…or mine now, anyways. There's our couch in the corner, facing daddy's TV. A glass coffee table is next to the couch. Our large baywindow looks out to the street.

I can see our kitchen to the west and our bedroom to the south. Our door out is to the east.

>w
Kitchen
Our small, little kitchen. Mommy always baked yummy chocolate chip cookies for me. There are some cupboards overhead. We have a sink, a refrigerator, a stove, and a floor mat. There's a jar of cookies here too.

I can see our living room to the east.

* * *

>look under mat
I find a key under the floor mat, which I bend down and pick up.

>unlock cupboards
(with the cupboard key)
I unlock the cupboards and open it.

>look inside cupboards
In Cupboards is a revolver.

>take colver
You can't see any such thing.

>take revolver
Taken.

* * *

>commands list
This is a list of commands available in the game. Other synonymous actions may exist. All possible exits are listed in the descriptions of every room. Available shortcuts for commands are in parenthesis. 

Commands: North (n), East (e), South (s), West (w), Examine (x), Look (l), Inventory (i), Unlock, Open, Press____ , 
Attack ____ with ____ , Shoot ____ with ____ ,  Put _____ in _____, Take ____ , Combine ____ with ____ , Look behind/under/inside ______ , Eat ______ , Break ____ with ____, Tie ____ with ____, Examine (x) me.

>shetoisehtoieshtte
That's not a verb I recognise.

>x tv
Our TV is on. It's replaying the statewide message that was sent out months ago. "Seek shelter and food. Stay inside at all times. Do NOT go outside in any case. This has been an official CEDA announcement."

>x window
I look out our open window. I can see a form of something crawling down below on the street but I can't really tell what it is.

I can probably tie something to this window.

>x kitchen
You can't see any such thing.

>w
Kitchen
Our small, little kitchen. Mommy always baked yummy chocolate chip cookies for me. There are some cupboards overhead. We have a sink, a refrigerator, a stove, and a floor mat. There's a jar of cookies here too.

I can see our living room to the east.

>x cupboards
Daddy hides something in here. I've tried opening it one time, but he keeps it locked up.

>sink
That's not a verb I recognise.

>sink
That's not a verb I recognise.

>x sink
Our sink. Daddy puts stuff underneath it.

>look underneath
You can't see any such thing.

>x refrigerator
It's the brand new white refrigerator we got a few months ago. There are letter magnets on it.

>take magnets
Mmmph! I can't move it!

I beg your pardon?

>x magnets
I made it spell "Hello" before but Daddy made it spell "tam rednu" I wonder what that means?

>x stove
There isn't much special about our stove.

>x mat
A regular, brown floor mat. It looks like it has been recently moved...

>look under matt
You can't see any such thing.

>x under matt
You can't see any such thing.

>x under mat
You can't see any such thing.

>x cookie
Yummy cookies!

>take cookies
Taken.

>eat cookies
Nom nom nom I eat up the chocolate chip cookies!

(Health: 100)
(Hunger: 100)

>x floor mat
A regular, brown floor mat. It looks like it has been recently moved...

>w
You can't go that way.

>s
You can't go that way.

>n
You can't go that way.

>e
Apartment Living Room
Our living room…or mine now, anyways. There's our couch in the corner, facing daddy's TV. A glass coffee table is next to the couch. Our large baywindow looks out to the street.

I can see our kitchen to the west and our bedroom to the south. Our door out is to the east.

>s
Bedroom
Our cozy, little bedroom. Mommy and Daddy have a big bed in the middle of the room, with a nightstand next to it. Our small closet is in the wall.

I can see our living room to the north and our bathroom to the west.

* * *

>x pillows
Big! Covered with big white pillowcases!

>x sheets
You can't see any such thing.

>x bedsheets
Big and long! Maybe I can combine something with this to make something useful...

>take bed sheets
I only understood you as far as wanting to take the bed.

>take bedsheets
Taken.

>take pillows
Taken.

>e
You can't go that way.

>e
You can't go that way.

>w
Bathroom
Our small bathroom. There's a toilet, a shower, a sink, and a medicine cabinet here.

I can see our bedroom to the east.

* * *

>x toilet
It's just our shiny, white toilet.

>x shower
It's just our shower.

It sounds like zombies are trying to break down the front door! I better hurry!!!

>x sink
Our sink. Nothing too special.

It sounds like zombies are trying to break down the front door! I better hurry!!!

>x cabinet
When I get sick or have a boo boo, Daddy gets some medicine or Band-aids from here.

It sounds like zombies are trying to break down the front door! I better hurry!!!

>pen cabinet
That's not a verb I recognise.

>open cabinet
I open the medicine cabinet and see 2 pills in here!

It sounds like zombies are trying to break down the front door! I better hurry!!!

>take pills
Taken.

It sounds like zombies are trying to break down the front door! I better hurry!!!

>at pills
That's not a verb I recognise.

>at pills
That's not a verb I recognise.

>eat pills
I eat the pills and suddenly I have no more pain in my boo-boos!
(Health: 100)
It sounds like zombies are trying to break down the front door! I better hurry!!!

>w
You can't go that way.

It sounds like zombies are trying to break down the front door! I better hurry!!!

>s
You can't go that way.

It sounds like zombies are trying to break down the front door! I better hurry!!!

>e
Bedroom
Our cozy, little bedroom. Mommy and Daddy have a big bed in the middle of the room, with a nightstand next to it. Our small closet is in the wall.

I can see our living room to the north and our bathroom to the west.

It sounds like zombies are trying to break down the front door! I better hurry!!!

>n
Apartment Living Room
Our living room…or mine now, anyways. There's our couch in the corner, facing daddy's TV. A glass coffee table is next to the couch. Our large baywindow looks out to the street.

I can see our kitchen to the west and our bedroom to the south. Our door out is to the east.

It sounds like zombies are trying to break down the front door! I better hurry!!!

>w
Kitchen
Our small, little kitchen. Mommy always baked yummy chocolate chip cookies for me. There are some cupboards overhead. We have a sink, a refrigerator, a stove, and a floor mat. There's a jar of cookies here too.

I can see our living room to the east.

It sounds like zombies are trying to break down the front door! I better hurry!!!

I beg your pardon?

>n
You can't go that way.

It sounds like zombies are trying to break down the front door! I better hurry!!!

I beg your pardon?

>w
You can't go that way.

It sounds like zombies are trying to break down the front door! I better hurry!!!

I beg your pardon?

>a
That's not a verb I recognise.

>w
You can't go that way.

It sounds like zombies are trying to break down the front door! I better hurry!!!

>e
Apartment Living Room
Our living room…or mine now, anyways. There's our couch in the corner, facing daddy's TV. A glass coffee table is next to the couch. Our large baywindow looks out to the street.

I can see our kitchen to the west and our bedroom to the south. Our door out is to the east.

It sounds like zombies are trying to break down the front door! I better hurry!!!

>e
As I walk to our front door, I hear scary noises coming from the other side. I don't want to go through there. I should find a different way out.

It sounds like zombies are trying to break down the front door! I better hurry!!!

>s
Bedroom
Our cozy, little bedroom. Mommy and Daddy have a big bed in the middle of the room, with a nightstand next to it. Our small closet is in the wall.

I can see our living room to the north and our bathroom to the west.

It sounds like zombies are trying to break down the front door! I better hurry!!!

>n
Apartment Living Room
Our living room…or mine now, anyways. There's our couch in the corner, facing daddy's TV. A glass coffee table is next to the couch. Our large baywindow looks out to the street.

I can see our kitchen to the west and our bedroom to the south. Our door out is to the east.

It sounds like zombies are trying to break down the front door! I better hurry!!!

>e
As I walk to our front door, I hear scary noises coming from the other side. I don't want to go through there. I should find a different way out.

It sounds like zombies are trying to break down the front door! I better hurry!!!

>w
Kitchen
Our small, little kitchen. Mommy always baked yummy chocolate chip cookies for me. There are some cupboards overhead. We have a sink, a refrigerator, a stove, and a floor mat. There's a jar of cookies here too.

I can see our living room to the east.

It sounds like zombies are trying to break down the front door! I better hurry!!!

>n
You can't go that way.

It sounds like zombies are trying to break down the front door! I better hurry!!!
The zombies knock down my front door and come swaming in! I guess it's over now…At least I get to see Mommy and Daddy now.

    *** You have died ***

Would you like to RESTART, RESTORE a saved game, QUIT or UNDO the last command?

* * *

>shoot zombie
You can't see any such thing.

* * *

>shoot zombie
What do you want to shoot Zombie with?

>revolver
I shoot my revolver but I miss!

A zombie is groaning and moaning and is trying to kill me!

The zombie hits me really hard! Owieee…to

My health goes down by 11.
(Health: 89)

>shoot zombie with flashlight
You need a gun to shoot, not a Flashlight.

A zombie is groaning and moaning and is trying to kill me!

The zombie hits me hard.

My health goes down by 2.
(Health: 87)

* * *

>xyzzy
Take one step forward: https://maps.google.com/maps?hl=en&ll=43.829221,12.304277&spn=0.001654,0.004128&t=h&layer=c&cbll=43.829283,12.303628&panoid=XwDtWY6SV5qMQcU3nr5KEQ&cbp=13,114.96,,0,14.51&z=19

* * *

>shoot myself with gun
You can't see any such thing.

* * *

>s
Bedroom
Our cozy, little bedroom. Mommy and Daddy have a big bed in the middle of the room, with a nightstand next to it. Our small closet is in the wall.

I can see our living room to the north and our bathroom to the west.

>w
Bathroom
Our small bathroom. There's a toilet, a shower, a sink, and a medicine cabinet here.

I can see our bedroom to the east.

>open medicine cabinet
I open the medicine cabinet and see 2 pills in here!

>take pills
Taken.

>eat pills
I eat the pills and suddenly I have no more pain in my boo-boos!
(Health: 100)

>eat pills
I eat the pills and suddenly I have no more pain in my boo-boos!
(Health: 100)

>eat pills
I don't have any more pills left…

>i
I'm carrying: 
0 pills
(Health: 100)

>x toilet
It's just our shiny, white toilet.

>sit on toilet
That's not something you can sit down on.

* * *

>s
Bedroom
Our cozy, little bedroom. Mommy and Daddy have a big bed in the middle of the room, with a nightstand next to it. Our small closet is in the wall.

I can see our living room to the north and our bathroom to the west.

>nw
Train
I'm standing on the train. It's derailed, but to the west the train engine car is still on. I look down at my feet and I can see the couple attaching the engine car to the rest of the derailed train.

I can see another train compartment to the east and the engine car to the west.

>s
Trainyard
I'm here at the trainyard. I see a rail stretching into the distance. A train is on the rail to the north but it is derailed. I can see a small little shack off to the south.

I can see the parking lot west of here and the train to the north.

There are zombies about!

>x train
You can't see any such thing.

* * *

>s
Bedroom
Our cozy, little bedroom. Mommy and Daddy have a big bed in the middle of the room, with a nightstand next to it. Our small closet is in the wall.

I can see our living room to the north and our bathroom to the west.

>take pillowcases
Taken.

>open nightstand
I open the nightstand and I can see a flashlight here and some yarn.

>take yar
You can't see any such thing.

>take yarn
Taken.

* * *

>combine yarn and pillowcase
You can't use multiple objects with that verb.

>x yarn
Some of Mommy's yarn. Maybe I can make something with it…

>w
Bathroom
Our small bathroom. There's a toilet, a shower, a sink, and a medicine cabinet here.

I can see our bedroom to the east.

>x medicine cabinet
When I get sick or have a boo boo, Daddy gets some medicine or Band-aids from here.

>open medicine cabinet
You open Medicine cabinet, revealing 2 pills.

* * *

>nw
You can't go that way.

* * *

>shoot revolver
You can't see any such thing.

* * *

>sw
Train
I'm standing on the train. It's derailed, but to the west the train engine car is still on. I look down at my feet and I can see the couple attaching the engine car to the rest of the derailed train.

I can see another train compartment to the east and the engine car to the west.

* * *

>take popo
You can't see any such thing.

* * *

>take poop
ANDY BAE IS A MILF.
CHEAT CODE ACTIVATED. DUN DUN DUN. RESTART IF YOU'RE NOT THE MAKER OF THE GAME.

Train
I'm standing on the train. It's derailed, but to the west the train engine car is still on. I look down at my feet and I can see the couple attaching the engine car to the rest of the derailed train.

I can see another train compartment to the east and the engine car to the west.

>xyzzy
That's not a verb I recognise.

* * *

>nothing
You can't see any such thing.

>shoot revolver with flashlight
There's nothing for me to shoot with the revolver…