It's getting dark outside and Mommy and Daddy haven't been home for 2 months. There are strange, dead people walking around outside, making scary noises. I don't like it here. It is frightening. I've run out of food. I need to find a way out.

For help, type "Commands List".

ANABELLE
An Interactive Fiction by Kai Wong
Release 1 / Serial number 130318 / Inform 7 build 6G60 (I6/v6.32 lib 6/12N) SD

Apartment Living Room
Our living room…or mine now, anyways. There's our couch in the corner, facing daddy's TV. A glass coffee table is next to the couch. Our large bay window looks out to the street.

I can see our kitchen to the west and our bedroom to the south. Our door out is to the east.

>x couch
It's a nice, cozy, black couch where I spent many days with Mommy and Daddy watching movies on our TV. My favorite was Finding Nemo.

>look under cocuh
You can't see any such thing.

>look under couch
Nothing much.

>x tv
Our TV is on. It's replaying the statewide message that was sent out months ago. "Seek shelter and food. Stay inside at all times. Do NOT go outside in any case. This has been an official CEDA announcement."

>x daddy's tv
You can't see any such thing.

>x table
Mommy left a note on top of the table for me.

>x note
Ella - We're heading into town for the day. We'll be back before nightfall. Don't worry, sweetie. - Love, Mommy.

>w
Kitchen
Our small, little kitchen. Mommy always baked yummy chocolate chip cookies for me. There are some cupboards overhead. We have a sink, a refrigerator, a stove, and a floor mat. There's a jar of cookies here too.

I can see our living room to the east.

>e
Apartment Living Room
Our living room…or mine now, anyways. There's our couch in the corner, facing daddy's TV. A glass coffee table is next to the couch. Our large bay window looks out to the street.

I can see our kitchen to the west and our bedroom to the south. Our door out is to the east.

>e
As I walk to our front door, I hear scary noises coming from the other side. I don't want to go through there. I should find a different way out.

>s
Bedroom
Our cozy, little bedroom. Mommy and Daddy have a big bed in the middle of the room, with a nightstand next to it. Our small closet is in the wall.

I can see our living room to the north and our bathroom to the west.

>x bed
Mommy and Daddy's big bed! I feel so small lying on it. They have such big pillows and big bedsheets!

>x pillows
Big! Covered with big white pillowcases!

>x pillowcases
Big! Maybe I can combine something with this pillowcase to make something useful…

>take pillowcases
Taken.

>x nightstand
Mommy and Daddy's nightstand. It has a drawer in it.

>open drawer
I open the nightstand and I can see a flashlight here and some yarn.

>take yarn
Taken.

>combine yarn with pillowcase
I now have a pillowcase bag!

>x bedsheets
Big and long! Maybe I can tie something to this to do something useful...

>take bedsheets
Taken.

>x closer
You can't see any such thing.

>x closet
You can't see any such thing.

>l
Bedroom
Our cozy, little bedroom. Mommy and Daddy have a big bed in the middle of the room, with a nightstand next to it. Our small closet is in the wall.

I can see our living room to the north and our bathroom to the west.

>w
Bathroom
Our small bathroom. There's a toilet, a shower, a sink, and a medicine cabinet here.

I can see our bedroom to the east.

>x toilet
It's just our shiny, white toilet.

>x shower
It's just our shower.

>x sink
Our sink. Nothing too special.

>x cabinet
When I get sick or have a boo boo, Daddy gets some medicine or Band-aids from here.

>open cabinet
I open the medicine cabinet and see 2 pills in here!

>take 2 pills
You can't see any such thing.

>2 pills
That's not a verb I recognise.

>take pills
Taken.

>l
Bathroom
Our small bathroom. There's a toilet, a shower, a sink, and a medicine cabinet here.

I can see our bedroom to the east.

>e
Bedroom
Our cozy, little bedroom. Mommy and Daddy have a big bed in the middle of the room, with a nightstand next to it. Our small closet is in the wall.

I can see our living room to the north and our bathroom to the west.

>n
Apartment Living Room
Our living room…or mine now, anyways. There's our couch in the corner, facing daddy's TV. A glass coffee table is next to the couch. Our large bay window looks out to the street.

I can see our kitchen to the west and our bedroom to the south. Our door out is to the east.

>w
Kitchen
Our small, little kitchen. Mommy always baked yummy chocolate chip cookies for me. There are some cupboards overhead. We have a sink, a refrigerator, a stove, and a floor mat. There's a jar of cookies here too.

I can see our living room to the east.

>x cookies
Yummy cookies!

>take cookies
Taken.

>x sink
Our sink. Daddy puts stuff underneath it.

>look under sink
I see Daddy's red fire axe here. I lift it up. It's quite heavy but I can manage, so I take it.

>x fridge
It's the brand new white refrigerator we got a few months ago. There are letter magnets on it.

>open fridge
Nothing much in here.

>closer fridge
That's not a verb I recognise.

>close fridge
That's not something you can close.

>x magnets
I made it spell "Hello" before but Daddy made it spell "tam rednu" I wonder what that means?

>take magnets
It's spelled out into a word…I shouldn't move it.

>look under mat
I find a key under the floor mat, which I bend down and pick up.

>unlock cupboards
What do you want to unlock Cupboards with?

>key
I unlock the cupboards and open it.

>look in cupboards
In Cupboards is a revolver.

>take revolver
Taken.

>x revolver
With great power comes great responsibility, my Daddy always told me. I barely know how to shoot something with this gun.

>shoot revolver
What do you want to shoot the revolver with?

>l
Kitchen
Our small, little kitchen. Mommy always baked yummy chocolate chip cookies for me. There are some cupboards overhead. We have a sink, a refrigerator, a stove, and a floor mat. There's a jar of cookies here too.

I can see our living room to the east.

>e
Apartment Living Room
Our living room…or mine now, anyways. There's our couch in the corner, facing daddy's TV. A glass coffee table is next to the couch. Our large bay window looks out to the street.

I can see our kitchen to the west and our bedroom to the south. Our door out is to the east.

* * *

>commands list
This is a list of commands available in the game. Other synonymous actions may exist. All possible exits are listed in the descriptions of every room. Available shortcuts for commands are in parenthesis. 

Commands: North (n), East (e), South (s), West (w), Examine (x), Look (l), Inventory (i), Unlock, Open, Press ____ , Attack ____ with ____ , Shoot ____ with ____ ,  Put _____ in _____ , Take ____ , Combine ____ with ____ , Look behind/under/inside ______ , Eat ______ , Break ____ with ____ , Tie ____ with ____ , Examine (x) me, Talk to ____

Helpful Tip: Examine everything!

* * *

>take all
I can't take everything I see!

* * *

>shoot zombie
You can't see any such thing.

>shoot gun
You can't see any such thing.

>nw
You can't go that way.

>take poop
ANDY BAE IS A MILF.
CHEAT CODE ACTIVATED. DUN DUN DUN. RESTART IF YOU'RE NOT THE MAKER OF THE GAME.

Train
I'm standing on the train. It's derailed, but to the west the train engine car is still on. I look down at my feet and I can see the couple attaching the engine car to the rest of the derailed train.

I can see another train compartment to the east and the engine car to the west.

>shoot gun
What do you want to shoot the revolver with?

>shoot revolver
What do you want to shoot the revolver with?

>bullets
You can't see any such thing.

>x revolver
With great power comes great responsibility, my Daddy always told me. I barely know how to shoot something with this gun.

>shoot zombie with flashlight
You can't see any such thing.

>i
I'm carrying: 
Cable cutters
Old rusty wrench
Spanner
a water bottle
Lever C
an axe
pillowcase bag
bedsheets
Flashlight
2 pills
a revolver
(Health: 100)

>s
Trainyard
I'm here at the trainyard. I see a rail stretching into the distance. A train is on the rail to the north but it is derailed. I can see a small little shack off to the south.

I can see the parking lot west of here and the train to the north.

There are zombies about!

>l
Trainyard
I'm here at the trainyard. I see a rail stretching into the distance. A train is on the rail to the north but it is derailed. I can see a small little shack off to the south.

I can see the parking lot west of here and the train to the north.

There are zombies about!

>l
Trainyard
I'm here at the trainyard. I see a rail stretching into the distance. A train is on the rail to the north but it is derailed. I can see a small little shack off to the south.

I can see the parking lot west of here and the train to the north.

A zombie takes notice of me!

>shoot zombie
What do you want to shoot Zombie with?

>revolver
I shoot my revolver but I miss!

A zombie is groaning and moaning and is trying to kill me!

The zombie hits me really hard! Owieee…to kill me!

My health goes down by 11.
(Health: 89)

>shoot zombie with flashlight
You need a gun to shoot, not a Flashlight.

A zombie is groaning and moaning and is trying to kill me!

The zombie hits me hard.

My health goes down by 2.
(Health: 87)

>shoot zombie
What do you want to shoot Zombie with?

* * *

>shoot myself with gun
You can't see any such thing.

>nw
You can't go that way.

>sw
You can't go that way.

>nw
You can't go that way.

>ne
You can't go that way.

>take poop
ANDY BAE IS A MILF.
CHEAT CODE ACTIVATED. DUN DUN DUN. RESTART IF YOU'RE NOT THE MAKER OF THE GAME.

Train
I'm standing on the train. It's derailed, but to the west the train engine car is still on. I look down at my feet and I can see the couple attaching the engine car to the rest of the derailed train.

I can see another train compartment to the east and the engine car to the west.

>shoot myself
What do you want to shoot yourself with?

* * *

>s
Bedroom
Our cozy, little bedroom. Mommy and Daddy have a big bed in the middle of the room, with a nightstand next to it.

I can see our living room to the north and our bathroom to the west.

>take pillowcase
Taken.

>open drawer
I open the nightstand and I can see a flashlight here and some yarn.

* * *

>take yarn
Taken.

>combine yarn and pillowcase
You can't use multiple objects with that verb.

>combine yarn with pillowcase
I now have a pillowcase bag!

>w
Bathroom
Our small bathroom. There's a toilet, a shower, a sink, and a medicine cabinet here.

I can see our bedroom to the east.

>open cabinet
I open the medicine cabinet and see 2 pills in here!

>take pills
Taken.

>e
Bedroom
Our cozy, little bedroom. Mommy and Daddy have a big bed in the middle of the room, with a nightstand next to it.

I can see our living room to the north and our bathroom to the west.

>take bedsheets
Taken.

>take flashlight
Taken.

>l
Bedroom
Our cozy, little bedroom. Mommy and Daddy have a big bed in the middle of the room, with a nightstand next to it.

I can see our living room to the north and our bathroom to the west.

>n
Apartment Living Room
Our living room…or mine now, anyways. There's our couch in the corner, facing daddy's TV. A glass coffee table is next to the couch. Our large bay window looks out to the street.

I can see our kitchen to the west and our bedroom to the south. Our door out is to the east.

* * *

>w
Kitchen
Our small, little kitchen. Mommy always baked yummy chocolate chip cookies for me. There are some cupboards overhead. We have a sink, a refrigerator, a stove, and a floor mat. There's a jar of cookies here too.

I can see our living room to the east.

>look under mat
I find a key under the floor mat, which I bend down and pick up.

>take cookies
Taken.

>unlock cupboard with key
(the cupboard key with the cupboard key)
That doesn't seem to be something you can unlock.

>unlock cupboard
What do you want to unlock the cupboard key with?

>key
I didn't understand that sentence.

>unlock cupboards with key
I unlock the cupboards and open it.

>look in cupboards
In Cupboards is a revolver.

>take revolver
With great power comes great responsibility, my Daddy always told me. I barely know how to shoot something with this gun.

>l
Kitchen
Our small, little kitchen. Mommy always baked yummy chocolate chip cookies for me. There are some cupboards overhead. We have a sink, a refrigerator, a stove, and a floor mat. There's a jar of cookies here too.

I can see our living room to the east.

>i
I'm carrying: 
a revolver
Cookies
a cupboard key
Flashlight
bedsheets
2 pills
pillowcase bag
(Health: 100)

>l
Kitchen
Our small, little kitchen. Mommy always baked yummy chocolate chip cookies for me. There are some cupboards overhead. We have a sink, a refrigerator, a stove, and a floor mat. There's a jar of cookies here too.

I can see our living room to the east.

* * *

>e
Apartment Living Room
Our living room…or mine now, anyways. There's our couch in the corner, facing daddy's TV. A glass coffee table is next to the couch. Our large bay window looks out to the street.

I can see our kitchen to the west and our bedroom to the south. Our door out is to the east.

>tie bedsheets to window
I tie the bedsheets to the window and let it hang down below to the ground.

>go through window
I climb down the bedsheets to the street below. Horay!

Parking Lot
I'm here in the parking lot in front of our small little apartment.

I can see a trainyard to the east and the town square to the west.

There are zombies about!

>w
Town Square
I'm here at the town square. I see some zombies milling about.

To the south I can see a small house. To the west I can see a general store. The parking lot is back to the east. To the north I can see a hardware store.

A zombie takes notice of me!

>s
Front of the Small House
I'm at the small, dark house. It looks scary! There's a door leading inside.

I see the town square to the north.

There are zombies about!

>n
Town Square
I'm here at the town square. I see some zombies milling about.

To the south I can see a small house. To the west I can see a general store. The parking lot is back to the east. To the north I can see a hardware store.

A zombie is groaning and moaning and is trying to kill me!

The zombie hits me hard.

My health goes down by 6.
(Health: 94)

>n
Front of the Hardware Store
I'm standing in front of the town's hardware store. The doors and windows are all boarded up.

I see the Town Square to the west.

There are zombies about!

>go in door
Hardware Store
I'm in the hardware store. There are a lot of towering shelves here.

Shelf A is to the north. Shelf B is to the east. Shelf C is to the west. The door out is to the south.

>n
Shelf A
I'm standing in the aisle of shelf A.

I see the main room to the south.

I see a pair of strong cable cutters here.

>take cutters
Taken.

>s
Hardware Store
I'm in the hardware store. There are a lot of towering shelves here.

Shelf A is to the north. Shelf B is to the east. Shelf C is to the west. The door out is to the south.

>e
Shelf B
I'm standing in the aisle of shelf B. I see the main room to the west.

Aieeee!

A zombie is groaning and moaning and is trying to kill me!

The zombie lunges at me but I dodge it.

>shoot zombie with gun
I shoot the person with my revolver, hitting him!
I damaged the zombie for 100 HP.
(Health: 0)

The zombie crumples to the ground.

>w
Hardware Store
I'm in the hardware store. There are a lot of towering shelves here.

Shelf A is to the north. Shelf B is to the east. Shelf C is to the west. The door out is to the south.

>w
Shelf C
I'm standing in the aisle of shelf C.

I see the main room to the east.

I see some batteries here!

>take batteries
I take the batteries and put it in my flashlight.

>e
Hardware Store
I'm in the hardware store. There are a lot of towering shelves here.

Shelf A is to the north. Shelf B is to the east. Shelf C is to the west. The door out is to the south.

>s
Front of the Hardware Store
I'm standing in front of the town's hardware store. The doors and windows are all boarded up.

I see the Town Square to the west.

A zombie takes notice of me!

>w
You can't go that way.

A zombie is groaning and moaning and is trying to kill me!

The zombie hits me hard.

My health goes down by 10.
(Health: 84)

>s
Town Square
I'm here at the town square. I see some zombies milling about.

To the south I can see a small house. To the west I can see a general store. The parking lot is back to the east. To the north I can see a hardware store.

There are zombies about!

>w
Front of the General Store
I'm standing in front of the town's small general store. Some of the letters on the sign are gone.

I see the Town Square to the east. The door to the general store is to the west.

>w
General Store.
I'm in the general store. The shelves have been knocked over and there are things strewn across the floor. There's a counter in the corner.

The exit is to the east.

I can see a tall man crouching behind one of the shelves.

You can also see a large bag here.

* * *

>nw
You can't go that way.

>i
I'm carrying: 
Cable cutters
Old rusty wrench
Spanner
a water bottle
Lever C
an axe
pillowcase bag
bedsheets
Flashlight
2 pills
a revolver
(Health: 100)

* * *

>take poop
ANDY BAE IS A MILF.
CHEAT CODE ACTIVATED. DUN DUN DUN. RESTART IF YOU'RE NOT THE MAKER OF THE GAME.

Train
I'm standing on the train. It's derailed, but to the west the train engine car is still on. I look down at my feet and I can see the couple attaching the engine car to the rest of the derailed train.

I can see another train compartment to the east and the engine car to the west.

>shoot revolver
What do you want to shoot the revolver with?

>nothing
You can't see any such thing.

>shoot revolver with flashlight
You can't shoot revolver.

* * *

>nw
You can't go that way.

>s
Trainyard
I'm here at the trainyard. I see a rail stretching into the distance. A train is on the rail to the north but it is derailed. I can see a small little shack off to the south.

I can see the parking lot west of here and the train to the north.

A zombie takes notice of me!

>x train
A derailed train to the north.

A zombie is groaning and moaning and is trying to kill me!

The zombie hits me hard.

My health goes down by 1.
(Health: 99)

>shoot zombie with gun
I shoot the person with my revolver, hitting him!
I damaged the zombie for 100 HP.
(Health: 0)

The zombie crumples to the ground.

>shoot gun
What do you want to shoot the revolver with?

>bullets
You can't see any such thing.

>n
Train
I'm standing on the train. It's derailed, but to the west the train engine car is still on. I look down at my feet and I can see the couple attaching the engine car to the rest of the derailed train.

I can see another train compartment to the east and the engine car to the west.

>break coupler with spanner
MMMMMMMPH!

*snap!*

The train coupler slides apart! Hooooray!

>x coupler
It's twisted together in an ugly angle, a result of the rear train cars becoming derailed. Maybe I can somehow break this coupler apart.

* * *

>nw
You can't go that way.

>x coupler
The train coupler is broken! The train can now move!

>break coupler with spanner
MMMMMMMPH!

*snap!*

The train coupler slides apart! Hooooray!

>break coupler with spanner
MMMMMMMPH!

*snap!*

The train coupler slides apart! Hooooray!

* * *

>nw
You can't go that way.

>restart
Are you sure you want to restart?

* * *

>shoot revolver
You can't see any such thing.

>take poop
ANDY BAE IS A MILF.
CHEAT CODE ACTIVATED. DUN DUN DUN. RESTART IF YOU'RE NOT THE MAKER OF THE GAME.

Train
I'm standing on the train. It's derailed, but to the west the train engine car is still on. I look down at my feet and I can see the couple attaching the engine car to the rest of the derailed train.

I can see another train compartment to the east and the engine car to the west.

* * *

>shoot revolver
What do you want to shoot the revolver with?

>flashlight
You can't shoot revolver.

* * *

>l
Apartment Living Room
Our living room…or mine now, anyways. There's our couch in the corner, facing daddy's TV. A glass coffee table is next to the couch. Our large bay window looks out to the street.

I can see our kitchen to the west and our bedroom to the south. Our door out is to the east.

>l
Apartment Living Room
Our living room…or mine now, anyways. There's our couch in the corner, facing daddy's TV. A glass coffee table is next to the couch. Our large bay window looks out to the street.

I can see our kitchen to the west and our bedroom to the south. Our door out is to the east.

I beg your pardon?

I beg your pardon?

>l
Apartment Living Room
Our living room…or mine now, anyways. There's our couch in the corner, facing daddy's TV. A glass coffee table is next to the couch. Our large bay window looks out to the street.

I can see our kitchen to the west and our bedroom to the south. Our door out is to the east.

>l
Apartment Living Room
Our living room…or mine now, anyways. There's our couch in the corner, facing daddy's TV. A glass coffee table is next to the couch. Our large bay window looks out to the street.

I can see our kitchen to the west and our bedroom to the south. Our door out is to the east.

I hear some odd groaning noises from behind the door. Zombies are trying to come in!

>l
Apartment Living Room
Our living room…or mine now, anyways. There's our couch in the corner, facing daddy's TV. A glass coffee table is next to the couch. Our large bay window looks out to the street.

I can see our kitchen to the west and our bedroom to the south. Our door out is to the east.

I hear some odd groaning noises from behind the door. Zombies are trying to come in!

I beg your pardon?

>l
Apartment Living Room
Our living room…or mine now, anyways. There's our couch in the corner, facing daddy's TV. A glass coffee table is next to the couch. Our large bay window looks out to the street.

I can see our kitchen to the west and our bedroom to the south. Our door out is to the east.

I hear some odd groaning noises from behind the door. Zombies are trying to come in!

>l
Apartment Living Room
Our living room…or mine now, anyways. There's our couch in the corner, facing daddy's TV. A glass coffee table is next to the couch. Our large bay window looks out to the street.

I can see our kitchen to the west and our bedroom to the south. Our door out is to the east.

I hear some odd groaning noises from behind the door. Zombies are trying to come in!
It sounds like zombies are trying to break down the front door! I better hurry!!!

>l
Apartment Living Room
Our living room…or mine now, anyways. There's our couch in the corner, facing daddy's TV. A glass coffee table is next to the couch. Our large bay window looks out to the street.

I can see our kitchen to the west and our bedroom to the south. Our door out is to the east.

I hear some odd groaning noises from behind the door. Zombies are trying to come in!
It sounds like zombies are trying to break down the front door! I better hurry!!!

* * *

>l
Apartment Living Room
Our living room…or mine now, anyways. There's our couch in the corner, facing daddy's TV. A glass coffee table is next to the couch. Our large bay window looks out to the street.

I can see our kitchen to the west and our bedroom to the south. Our door out is to the east.

>l
Apartment Living Room
Our living room…or mine now, anyways. There's our couch in the corner, facing daddy's TV. A glass coffee table is next to the couch. Our large bay window looks out to the street.

I can see our kitchen to the west and our bedroom to the south. Our door out is to the east.

I hear some odd groaning noises from behind the front door. Zombies are trying to come in!

>l
Apartment Living Room
Our living room…or mine now, anyways. There's our couch in the corner, facing daddy's TV. A glass coffee table is next to the couch. Our large bay window looks out to the street.

I can see our kitchen to the west and our bedroom to the south. Our door out is to the east.

I hear some odd groaning noises from behind the front door. Zombies are trying to come in!

>l
Apartment Living Room
Our living room…or mine now, anyways. There's our couch in the corner, facing daddy's TV. A glass coffee table is next to the couch. Our large bay window looks out to the street.

I can see our kitchen to the west and our bedroom to the south. Our door out is to the east.

I hear some odd groaning noises from behind the front door. Zombies are trying to come in!
It sounds like zombies are trying to break down the front door! I better hurry!!!

>l
Apartment Living Room
Our living room…or mine now, anyways. There's our couch in the corner, facing daddy's TV. A glass coffee table is next to the couch. Our large bay window looks out to the street.

I can see our kitchen to the west and our bedroom to the south. Our door out is to the east.

I hear some odd groaning noises from behind the front door. Zombies are trying to come in!
It sounds like zombies are trying to break down the front door! I better hurry!!!

* * *

>e
As I walk to our front door, I hear scary noises coming from the other side. I don't want to go through there. I should find a different way out.

>e
As I walk to our front door, I hear scary noises coming from the other side. I don't want to go through there. I should find a different way out.

* * *

>sw
Train
I'm standing on the train. It's derailed, but to the west the train engine car is still on. I look down at my feet and I can see the couple attaching the engine car to the rest of the derailed train.

I can see another train compartment to the east and the engine car to the west.

* * *

>take popo
You can't see any such thing.

>take poop
ANDY BAE IS A MILF.
CHEAT CODE ACTIVATED. DUN DUN DUN. RESTART IF YOU'RE NOT THE MAKER OF THE GAME.

Train
I'm standing on the train. It's derailed, but to the west the train engine car is still on. I look down at my feet and I can see the couple attaching the engine car to the rest of the derailed train.

I can see another train compartment to the east and the engine car to the west.

* * *

>shoot revolver
What do you want to shoot the revolver with?

>nothig
You can't see any such thing.

>shoot revolver
What do you want to shoot the revolver with?

* * *

>x kitchen
You can't see any such thing.

>x living room
You can't see any such thing.

>x corner
You can't see any such thing.

>x tv
Our TV is on. It's replaying the statewide message that was sent out months ago. "Seek shelter and food. Stay inside at all times. Do NOT go outside in any case. This has been an official CEDA announcement."

>lift
That's not a verb I recognise.

>restart
Are you sure you want to restart?