It's getting dark outside and Mommy and Daddy haven't been home for 2 months. There's strange, dead people walking around outside, making scary noises. I don't like it here. It is frightening. I've run out of food. I need to find a way out.

ANABELLE
An Interactive Fiction by Kai Wong
Release 1 / Serial number 130309 / Inform 7 build 6G60 (I6/v6.32 lib 6/12N) SD

Apartment Living Room
Our living room…or mine now, anyways. There's our couch in the corner, facing daddy's TV. A glass coffee table is next to the couch. Our large baywindow looks out to the street.

I can see our kitchen to the west and our bedroom to the south. Our door out is to the east.

>nw
Town Square
I'm here at the town square. I see some zombies milling about.

To the south I can see a small house. To the west I can see a general store. The parking lot is back to the east. To the north I can see a hardware store.

There are zombies about!

>w
Front of the General Store
I'm standing in front of the town's small general store. Some of the letters on the sign are gone.

I see the Town Square to the east. The door to the general store is to the west.

A zombie takes notice of me!

>w
(first opening the general store's door)

General Store.
I'm in the general store. The shelves have been knocked over and there are things strewn across the floor.

The exit is to the east.

I can see a tall man crouching behind one of the shelves.

>ask man for bag
"Oh, it's just my bag, you know" he says. "Nothing in it for you, really."

>ask man for bag
"I should somehow convince him to give me his bag.

* * *

>ask man for bag
"Oh, it's just my bag, you know" he says. "Nothing in it for you, really."

>ask man for cake
You can't see any such thing.

* * *

>ask man for bag
"Oh, it's just my bag, you know" he says. "Nothing in it for you, really."

>ask man for large bag
ha

* * *

>w
(first opening the general store's door)

General Store.
I'm in the general store. The shelves have been knocked over and there are things strewn across the floor.

The exit is to the east.

I can see a tall man crouching behind one of the shelves.

>ask tallman for bag
"Oh, it's just my bag, you know" he says. "Nothing in it for you, really."

>give revolver to tallman
The tall man looks at the revolver and asks "Really? For me? Wow, thank you! I really needed a weapon.

>ask tallman for bag
"Sure, take my bag!

* * *

>w
(first opening the general store's door)

General Store.
I'm in the general store. The shelves have been knocked over and there are things strewn across the floor.

The exit is to the east.

I can see a tall man crouching behind one of the shelves.

>give gun to man
The tall man looks at the revolver and asks "Really? For me? Wow, thank you! I really needed a weapon."

>take bag
Mmmph! I can't move it!

>ask man for bag
"Sure, little girl!" he says happily. "Take what you want from my bag!"

I open the bag and there are tons of goodies! I take some potato chips, a can of SPAM, some chicken noodle soup and a water bottle.

>x water bottle
A small, dark green water bottle. There isn't a single drop of water in here! i should go fill it up someplace.

* * *

>w
(first opening the general store's door)

General Store.
I'm in the general store. The shelves have been knocked over and there are things strewn across the floor.

The exit is to the east.

I can see a tall man crouching behind one of the shelves.

>give revolver to man
The tall man looks at the revolver and asks "Really? For me? Wow, thank you! I really needed a weapon."

>ask tallman for bag
"Sure, little girl!" he says happily. "Take what you want from my bag!"

I open the bag and there are tons of goodies! I take some potato chips, a can of SPAM, some chicken noodle soup and a water bottle.

>x water bottle
A small, dark green water bottle. There's some water in here.

>drink water bottle
I drink the water in the bottle!

>x water bottle
A small, dark green water bottle. There isn't a single drop of water in here! i should go fill it up someplace.

* * *

>w
(first opening the general store's door)

General Store.
I'm in the general store. The shelves have been knocked over and there are things strewn across the floor.

The exit is to the east.

I can see a tall man crouching behind one of the shelves.

>kill man
I try to kill the man with my gun but I miss! He runs out of the room.

* * *

>w
(first opening the general store's door)

General Store.
I'm in the general store. The shelves have been knocked over and there are things strewn across the floor.

The exit is to the east.

I can see a tall man crouching behind one of the shelves.

>attack man with revover
You can't see any such thing.

* * *

>w
(first opening the general store's door)

General Store.
I'm in the general store. The shelves have been knocked over and there are things strewn across the floor.

The exit is to the east.

I can see a tall man crouching behind one of the shelves.

>give flashlight to tallman
The tall man looks at it, but he doesn't appear interested. "I have tons of that stuff already," he says."

* * *

>w
(first opening the general store's door)

General Store.
I'm in the general store. The shelves have been knocked over and there are things strewn across the floor.

The exit is to the east.

I can see a tall man crouching behind one of the shelves.

>x man
He's pretty tall. He's watching me carefully and I don't think he's armed. He has a large bag with him.

I can: talk, ask, give.

>talk to man
"Hi, mister." you say timidly.

"Hello, little girl. What is your name?" says the tall man.

"My name is Anabelle."

"That's a nice name, Anabelle." he says.

>x bag
(pillowcase bag)
You see nothing special about pillowcase bag.

>x large bag
The man's large bag.

>ask man about bag
"Oh, it's just my bag, you know" he says. "Nothing in it for you, really."

>give flashlight to man
tall man doesn't seem interested.

* * *

>x man
He's pretty tall. He's watching me carefully and I don't think he's armed. He has a large bag with him.

I can: talk, ask, give.

>ask man
What do you want to ask tall man for?

>nothing
You can't see any such thing.

>talk man
I didn't understand that sentence.

>talk to mna
You can't see any such thing.

>talk to man
"Hi, mister." you say timidly.

"Hello, little girl. What is your name?" says the tall man.

"My name is Anabelle."

"That's a nice name, Anabelle." he says.

>talk to man
I should ask him a question.

* * *

>w
(first opening the general store's door)

General Store.
I'm in the general store. The shelves have been knocked over and there are things strewn across the floor.

The exit is to the east.

I can see a tall man crouching behind one of the shelves.

>talk to man
"Hi, mister." you say timidly.

"Hello, little girl. What is your name?" says the tall man.

"My name is Anabelle."

"That's a nice name, Anabelle." he says.

>talk to man
I should ask him for something.

>ask man about bag
There is no reply.

* * *

>w
(first opening the general store's door)

General Store.
I'm in the general store. The shelves have been knocked over and there are things strewn across the floor.

The exit is to the east.

I can see a tall man crouching behind one of the shelves.

>talk to max
You can't see any such thing.

* * *

>w
Front of the General Store
I'm standing in front of the town's small general store. Some of the letters on the sign are gone.

I see the Town Square to the east. The door to the general store is to the west.

A zombie takes notice of me!

>ask man for bag
You can't see any such thing.

>w
(first opening the general store's door)

General Store.
I'm in the general store. The shelves have been knocked over and there are things strewn across the floor.

The exit is to the east.

I can see a tall man crouching behind one of the shelves.

>ask man for bag
(pillowcase bag)
Why would I want to give him my bag?

* * *

>nw
Town Square
I'm here at the town square. I see some zombies milling about.

To the south I can see a small house. To the west I can see a general store. The parking lot is back to the east. To the north I can see a hardware store.

There are zombies about!

>i
I'm carrying: 
Lever C
an axe
pillowcase bag
bedsheets
Batteries
Flashlight
2 pills
1 bandaids
a case of 8 bullet(s) for Daddy's revolver
a revolver
(Health: 100)

A zombie is groaning and moaning and is trying to kill me!

The zombie lunges at me but I dodge it.

* * *

>nw
Town Square
I'm here at the town square. I see some zombies milling about.

To the south I can see a small house. To the west I can see a general store. The parking lot is back to the east. To the north I can see a hardware store.

There are zombies about!

>s
Front of the Small House
I'm at the small, dark house. It looks scary! There's a door leading inside.

I see the town square to the north.

A zombie takes notice of me!

>n
Town Square
I'm here at the town square. I see some zombies milling about.

To the south I can see a small house. To the west I can see a general store. The parking lot is back to the east. To the north I can see a hardware store.

There are zombies about!

>w
Front of the General Store
I'm standing in front of the town's small general store. Some of the letters on the sign are gone.

I see the Town Square to the east. The door to the general store is to the west.

There are zombies about!

>w
(first opening the general store's door)

General Store.
I'm in the general store. The shelves have been knocked over and there are things strewn across the floor.

The exit is to the east.

I can see a tall man crouching behind one of the shelves.

>talk to man
"Hi, mister." you say timidly.

"Hello, little girl. What is your name?" says the tall man.

"My name is Anabelle."

"That's a nice name, Anabelle." he says, shifting his weight to hide his bag.

>talk to man
I should ask him for something.

>ask for bag
You can't see any such thing.

>ask man for his bag
You can't see any such thing.

>ask man for bag
(pillowcase bag)
(tall man first taking pillowcase bag)
tall man has better things to do.

>ask man about bag
"Oh, it's just my bag, you know" he says. "Nothing in it for you, really."

* * *

>s
Front of the Small House
I'm at the small, dark house. It looks scary! There's a door leading inside.

I see the town square to the north.

A zombie takes notice of me!

>s
(first opening the small house's door)
I open the door.

Small House's Living Room
I'm in the small house's living room. There's not much here, just a dusty couch and a broken TV.

I see the exit to the north and the kitchen to the west.

There's a zombie here!

>s
Backyard of the Small House
It's a nice, small backyard, covered with grass and plants. I see a small water cistern near the wall.

To the north I can see the living room.

>use cistern
I fill my water bottle full of crystal clean water!

>drink water
I drink the nice cool water from my water bottle! Mmm, refrshing!

(Health: 100)
(Hunger: 100)

>use cistern
I fill my water bottle full of crystal clean water!

>nw
Town Square
I'm here at the town square. I see some zombies milling about.

To the south I can see a small house. To the west I can see a general store. The parking lot is back to the east. To the north I can see a hardware store.

There are zombies about!

* * *

>w
(first opening the general store's door)

General Store.
I'm in the general store. The shelves have been knocked over and there are things strewn across the floor.

The exit is to the east.

I can see a tall man crouching behind one of the shelves.

>kill man
Violence isn't the answer to this one.

* * *

>s
(first opening the small house's door)
I open the door.

Small House's Living Room
I'm in the small house's living room. There's not much here, just a dusty couch and a broken TV.

I see the exit to the north and the kitchen to the west.

There's a zombie here!

>shoot zombie with gun
I shoot the person with my revolver, hitting him!
I damaged the zombie for 100 HP.
(Health: 0)

The zombie crumples to the ground.

>s
Backyard of the Small House
It's a nice, small backyard, covered with grass and plants. I see a small water cistern near the wall.

To the north I can see the living room.

>n
Small House's Living Room
I'm in the small house's living room. There's not much here, just a dusty couch and a broken TV.

I see the exit to the north and the kitchen to the west.

>w
Small House's Kitchen
I'm in the kitchen. This place looks like a mess, with everything spilled everywhere and things hanging lopsidedly. There are some cupboards here.

I see the living room to the east and the backyard to the south.

>open cupboards
I open the cupboards and I can see some: 
Canned Salisbury Steak
Canned Beans
Coke

>take coke
Taken.

>drink coke
I pry open the cap of the coke and I can hear the bubbling and fizzing! I quickly drink it down. Ahh! Good stuff.

(Health: 100)
(Hunger: 100)