>nwn
That's not a verb I recognise.

>nw
Parking Lot
I'm here in the parking lot in front of our small little apartment.

I can see a trainyard to the west and the town square to the east.

I can see a strange looking person here. He's lying on the pavement, pawing at something and making groaning noises.

* * *

>nw
Parking Lot
I'm here in the parking lot in front of our small little apartment.

I can see a trainyard to the west and the town square to the east.

You can see Strange Looking Person here.

I can see a strange looking person here. He's lying on the pavement, pawing at something and making groaning noises.

I beg your pardon?

>i
I'm carrying: 
an axe
Bedsheets
2 pills
1 bandaids
a case of 8 bullet(s) for Daddy's revolver
a revolver
(Health: 100)

>l
Parking Lot
I'm here in the parking lot in front of our small little apartment.

I can see a trainyard to the west and the town square to the east.

I can see a strange looking person here. He's lying on the pavement, pawing at something and making groaning noises.

The strange looking person notices me and gets up, groaning and moaning. It's coming for me!

>nw
Parking Lot
I'm here in the parking lot in front of our small little apartment.

I can see a trainyard to the west and the town square to the east.

I can see a strange looking person here. He's lying on the pavement, pawing at something and making groaning noises.

The strange looking person notices me and gets up, groaning and moaning. It's coming for me!

>restart
Are you sure you want to restart?

* * *

>nw
Parking Lot
I'm here in the parking lot in front of our small little apartment.

I can see a trainyard to the west and the town square to the east.

You can see Strange Looking Person here.

I can see a strange looking person here. He's lying on the pavement, pawing at something and making groaning noises.

>i
I'm carrying: 
an axe
Bedsheets
2 pills
1 bandaids
a case of 8 bullet(s) for Daddy's revolver
a revolver
(Health: 100)

>nw
Parking Lot
I'm here in the parking lot in front of our small little apartment.

I can see a trainyard to the west and the town square to the east.

I can see a strange looking person here. He's lying on the pavement, pawing at something and making groaning noises.

The strange looking person notices me and gets up, groaning and moaning. It's coming for me!

>i
I'm carrying: 
an axe
Bedsheets
2 pills
1 bandaids
a case of 8 bullet(s) for Daddy's revolver
a revolver
(Health: 100)

>l
Parking Lot
I'm here in the parking lot in front of our small little apartment.

I can see a trainyard to the west and the town square to the east.

I can see a strange looking person here. He's lying on the pavement, pawing at something and making groaning noises.

* * *

>nw
Parking Lot
I'm here in the parking lot in front of our small little apartment.

I can see a trainyard to the west and the town square to the east.

You can see Strange Looking Person here.

I can see a strange looking person here. He's lying on the pavement, pawing at something and making groaning noises.

>nw
Parking Lot
I'm here in the parking lot in front of our small little apartment.

I can see a trainyard to the west and the town square to the east.

You can see Strange Looking Person here.

I can see a strange looking person here. He's lying on the pavement, pawing at something and making groaning noises.

>nw
Parking Lot
I'm here in the parking lot in front of our small little apartment.

I can see a trainyard to the west and the town square to the east.

You can see Strange Looking Person here.

The strange looking person notices me and gets up, groaning and moaning. It's coming for me!

* * *

>nw
Parking Lot
I'm here in the parking lot in front of our small little apartment.

I can see a trainyard to the west and the town square to the east.

You can see Strange Looking Person here.

I can see a strange looking person here. He's lying on the pavement, pawing at something and making groaning noises.

>l
Parking Lot
I'm here in the parking lot in front of our small little apartment.

I can see a trainyard to the west and the town square to the east.

I can see a strange looking person here. He's lying on the pavement, pawing at something and making groaning noises.

>l
Parking Lot
I'm here in the parking lot in front of our small little apartment.

I can see a trainyard to the west and the town square to the east.

I can see a strange looking person here. He's lying on the pavement, pawing at something and making groaning noises.

I can see a strange looking person here. He's lying on the pavement, pawing at something and making groaning noises.

The strange looking person notices me and gets up, groaning and moaning. It's coming for me!

>l
Parking Lot
I'm here in the parking lot in front of our small little apartment.

I can see a trainyard to the west and the town square to the east.

I can see a strange looking person here. He's lying on the pavement, pawing at something and making groaning noises.

The strange looking person is groaning and moaning and is trying to kill me!

* * *

>nw
Parking Lot
I'm here in the parking lot in front of our small little apartment.

I can see a trainyard to the west and the town square to the east.

You can see Strange Looking Person here.

I can see a strange looking person here. He's lying on the pavement, pawing at something and making groaning noises.

>attack person
What do I attack the person with?

>with axe
That's not a verb I recognise.

>attack person with axe
My axe swing sinks into the zombie!
I damaged the zombie for 30 HP.
(Health: 70)

The strange looking person notices me and gets up, groaning and moaning. It's coming for me!

>i
I'm carrying: 
an axe
Bedsheets
2 pills
1 bandaids
a case of 8 bullet(s) for Daddy's revolver
a revolver
(Health: 100)

The strange looking person notices me and gets up, groaning and moaning. It's coming for me!

>i
I'm carrying: 
an axe
Bedsheets
2 pills
1 bandaids
a case of 8 bullet(s) for Daddy's revolver
a revolver
(Health: 100)

The strange looking person notices me and gets up, groaning and moaning. It's coming for me!
The zombie hits me really hard! Owieee…My health goes down by 23.
I can almost pretend I don't hurt right now.
I don't feel hungry at all right now! Let's go do something.
. (Health: 77)

>i
I'm carrying: 
an axe
Bedsheets
2 pills
1 bandaids
a case of 8 bullet(s) for Daddy's revolver
a revolver
(Health: 77)

The strange looking person notices me and gets up, groaning and moaning. It's coming for me!
The zombie swings at me but I dodge it.

>i
I'm carrying: 
an axe
Bedsheets
2 pills
1 bandaids
a case of 8 bullet(s) for Daddy's revolver
a revolver
(Health: 77)

The strange looking person notices me and gets up, groaning and moaning. It's coming for me!

>i
I'm carrying: 
an axe
Bedsheets
2 pills
1 bandaids
a case of 8 bullet(s) for Daddy's revolver
a revolver
(Health: 77)

The strange looking person notices me and gets up, groaning and moaning. It's coming for me!

>i
I'm carrying: 
an axe
Bedsheets
2 pills
1 bandaids
a case of 8 bullet(s) for Daddy's revolver
a revolver
(Health: 77)

The strange looking person notices me and gets up, groaning and moaning. It's coming for me!
The zombie swings at me but I dodge it.

* * *

>s
Bedroom
Our cozy, little bedroom. Mommy and Daddy have a big bed in the middle of the room, with a nightstand next to it. Our small closet is in the wall.

I can see our living room to the north and our bathroom to the west.

>open nightstand
I open the nightstand and I can see a flashlight here.

>look inside nightstand
In Nightstand is Flashlight.

>take flashlight
Taken.

>turn on flashlight
The flashlight doesn't have batteries…

* * *

>s
Bedroom
Our cozy, little bedroom. Mommy and Daddy have a big bed in the middle of the room, with a nightstand next to it. Our small closet is in the wall.

I can see our living room to the north and our bathroom to the west.

>look inside nightstand
You can't see inside, since Nightstand is closed.

>open nightstand
I open the nightstand and I can see a flashlight here.

* * *

>s
Bedroom
Our cozy, little bedroom. Mommy and Daddy have a big bed in the middle of the room, with a nightstand next to it. Our small closet is in the wall.

I can see our living room to the north and our bathroom to the west.

>takeall
That's not a verb I recognise.

>take all
There are none at all available!

>x bed
Mommy and Daddy's big bed! I feel so small lying on it. They have such big pillows and big bedsheets!

* * *

>take bedsheets
Taken.

>x bedsheets
Big and long! Maybe I can use these somehow...

>tie bedsheets to window
You can't see any such thing.

>n
Apartment Living Room
Our living room…or mine now, anyways. There's our couch in the corner, facing daddy's TV where I watch Sesame Street. A glass coffee table is next to the couch. A large baywindow looks out to the street.

I can see our kitchen to the west and our bedroom to the south. Our door out is to the east.

>tie bedsheets to window
I tie the bedsheets to the window and let it hang down below to the ground.

* * *

>s
Bedroom
Our cozy, little bedroom. Mommy and Daddy have a big bed in the middle of the room, with a nightstand next to it. Our small closet is in the wall.

I can see our living room to the north and our bathroom to the west.

>x nightstand
Mommy and Daddy's nightstand. It has a drawer in it.

>open drawer
You can't see any such thing.

* * *

>s
Bedroom
Our cozy, little bedroom. Mommy and Daddy have a big bed in the middle of the room, with a nightstand next to it. Our small closet is in the wall.

I can see our living room to the north and our bathroom to the west.

>take bedsheets
Taken.

>n
Apartment Living Room
Our living room…or mine now, anyways. There's our couch in the corner, facing daddy's TV where I watch Sesame Street. A glass coffee table is next to the couch. A large baywindow looks out to the street.

I can see our kitchen to the west and our bedroom to the south. Our door out is to the east.

>open window
That's already open.

>tie bedsheets to window
I tie the bedsheets to the window and let it hang down below to the ground.

* * *

>s
Bedroom
Our cozy, little bedroom. Mommy and Daddy have a big bed in the middle of the room, with a nightstand next to it. Our small closet is in the wall.

I can see our living room to the north and our bathroom to the west.

>open drawer
I open the nightstand and I can see a flashlight here.

>take flashlight
You can't see any such thing.

>look inside nightstand
You can't see inside, since Nightstand is closed.

* * *

>open drawer
I open the nightstand and I can see a flashlight here.

>x flashlight
You can't see any such thing.

>take flashlight
You can't see any such thing.