It's getting dark outside and Mommy and Daddy haven't been home for 2 months. There's strange, dead people walking around outside, making scary noises. I don't like it here. It is frightening. I've run out of food. I need to find a way out.

ANABELLE
An Interactive Fiction by Kai Wong
Release 1 / Serial number 130301 / Inform 7 build 6G60 (I6/v6.32 lib 6/12N) SD

Apartment Living Room
Our living room…or mine now, anyways. There's our couch in the corner, facing daddy's TV where I watch Sesame Street. A glass coffee table is next to the couch. A large baywindow looks out to the street.

I can see our kitchen to the west and our bedroom to the south. Our door out is to the east.

>l
Apartment Living Room
Our living room…or mine now, anyways. There's our couch in the corner, facing daddy's TV where I watch Sesame Street. A glass coffee table is next to the couch. A large baywindow looks out to the street.

I can see our kitchen to the west and our bedroom to the south. Our door out is to the east.

>l
Apartment Living Room
Our living room…or mine now, anyways. There쁕୤'s our couch in the corner, facing daddy's TV where I watch Sesame Street. A glass coffee table is next to the couch. A large baywindow looks out to the street.

I can see our kitchen to the west and our bedroom to the south. Our door out is to the east.

>l
Apartment Living Room
Our living room…or mine now, anyways. There's our couch in the corner, facing daddy's TV where I watch Sesame Street. A glass coffee table is next to the couch. A large baywindow looks out to the street.

I can see our kitchen to the west and our bedroom to the south. Our door out is to the east.

>l
Apartment Living Room
Our living room…or mine now, anyways. There's our couch in the corner, facing daddy's TV where I watch Sesame Street. A glass coffee table is next to the couch. A large baywindow looks out to the street.

I can see our kitchen to the west and our bedroom to the south. Our door out is to the east.

>l
Apartment Living Room
Our living room…or mine now, anyways. There夀's our couch in the corner, facing daddy's TV where I watch Sesame Street. A glass coffee table is next to the couch. A large baywindow looks out to the street.

I can see our kitchen to the west and our bedroom to the south. Our door out is to the east.

>l
Apartment Living Room
Our living room…or mine now, anyways. There's our couch in the corner, facing daddy's TV where I watch Sesame Street. A glass coffee table is next to the couch. A large baywindow looks out to the street.

I can see our kitchen to the west and our bedroom to the south. Our door out is to the east.

* * *

>x baywindow
I look out our open window. I can see a form of something crawling down below on the street but I can't really tell what it is.

>s
Bedroom
Our cozy, little bedroom. Mommy and Daddy have a big bed in the middle of the room, with a nightstand next to it. Our small closet is in the wall.

I can see our living room to the north and our bathroom to the west.

* * *

>x bed
Mommy and Daddy's big bed! I feel so small lying on it. They have such big pillows and big bedsheets!

>take bedsheets
Taken.

>n
Apartment Living Room
Our living room…or mine now, anyways. There夀's our couch in the corner, facing daddy's TV where I watch Sesame Street. A glass coffee table is next to the couch. A large baywindow looks out to the street.

I can see our kitchen to the west and our bedroom to the south. Our door out is to the east.

>tie bedsheets to window
I tie the bedsheets to the window and let it hang down below to the ground.

>go through window
You can't go that way.

>n
You can't go that way.

>open window
That's already open.

* * *

>x baywindow
I look out our open window. I can see a form of something crawling down below on the street but I can't really tell what it is.

>x window
I look out our open window. I can see a form of something crawling down below on the street but I can't really tell what it is.

* * *

>e
As I walk to our front door, I hear scary noises coming from the other side. I don't want to go through there.

>e
As I walk to our front door, I hear scary noises coming from the other side. I don't want to go through there.

>e
As I open the door, a dozen zombies flood into the room, groaning and moaning, reaching and grasping their rotten arms towards me. I am trapped. I guess I'll be seeing Mommy and Daddy again very soon.

    *** You have died ***

Would you like to RESTART, RESTORE a saved game, QUIT or UNDO the last command?

* * *

>nw
Parking Lot
I'm here in the parking lot in front of our small little apartment.

I can see a trainyard to the west and the town square to the east.

I can see a strange looking person here. He's lying on the pavement, pawing at something and making groaning noises.

>shoot person with gun
I shoot the person with my revolver, hitting him!
I damaged the zombie for 100 HP.
(Health: 0)

I can see a strange looking person here. He's lying on the pavement, pawing at something and making groaning noises.

I land a killing blow and the person falls to the ground!

>attack person with gun
The strange looking person notices me and gets up, groaning and moaning. It's coming for me!

The strange looking person is groaning and moaning and is trying to kill me!
The strange looking person hits me really hard! Owieee…My health goes down by 12.
I have some cuts and bruises. Where's Mommy to help put on Band-aids?
I'm not hungry at all. Let's go do something!
. (Health: 88)

>shot person with gun
That's not a verb I recognise.

>shoot person with gun
I shoot my revolver but I miss!

The strange looking person is groaning and moaning and is trying to kill me!
The strange looking person swings at me but I dodge it.

>shoot person with gun
I shoot the person with my revolver, hitting him!
I damaged the zombie for 99 HP.
(Health: -89)

The strange looking person is groaning and moaning and is trying to kill me!
The strange looking person hits me hard.
My health goes down by 1.
(Health: 87)

I land a killing blow and the person falls to the ground!

>l
Parking Lot
I'm here in the parking lot in front of our small little apartment.

I can see a trainyard to the west and the town square to the east.

I see the dead person just lying here.

>x dead person
You can't see any such thing.

* * *

>shoot person with gun
I shoot the person with my revolver, hitting him!
I damaged the zombie for 100 HP.
(Health: 0)

I can see a strange looking person here. He's lying on the pavement, pawing at something and making groaning noises.

I land a killing blow and the person falls to the ground!

>shoot person with gun
I shoot the person with my revolver, hitting him!
I damaged the zombie for 100 HP.
(Health: 0)

The strange looking person notices me and gets up, groaning and moaning. It's coming for me!

The strange looking person is groaning and moaning and is trying to kill me!
The strange looking person hits me hard.
My health goes down by 6.
(Health: 94)

I land a killing blow and the person falls to the ground!

>x person
You can't see any such thing.

>l
Parking Lot
I'm here in the parking lot in front of our small little apartment.

I can see a trainyard to the west and the town square to the east.

I see the dead person just lying here.

>x person
Dead body of the disfigured person. Scary.

I see the dead person just lying here.

* * *

>shoot person with gun
I shoot the person with my revolver, hitting him!
I damaged the zombie for 100 HP.
(Health: 0)

I can see a strange looking person here. He's lying on the pavement, pawing at something and making groaning noises.

I land a killing blow and the person falls to the ground!

>l
Parking Lot
I'm here in the parking lot in front of our small little apartment.

I can see a trainyard to the west and the town square to the east.

>l
Parking Lot
I'm here in the parking lot in front of our small little apartment.

I can see a trainyard to the west and the town square to the east.

You can see dead person here.

I beg your pardon?

>l
Parking Lot
I'm here in the parking lot in front of our small little apartment.

I can see a trainyard to the west and the town square to the east.

You can see dead person here.

>l
Parking Lot
I'm here in the parking lot in front of our small little apartment.

I can see a trainyard to the west and the town square to the east.

You can see dead person here.

* * *

>shoot person with gun
I shoot the person with my revolver, hitting him!
I damaged the zombie for 100 HP.
(Health: 0)

I can see a strange looking person here. He's lying on the pavement, pawing at something and making groaning noises.

I land a killing blow and the person falls to the ground!

>x dead person
You can't see any such thing.

>l
Parking Lot
I'm here in the parking lot in front of our small little apartment.

I can see a trainyard to the west and the town square to the east.

I see the dead person just lying here.

>x dead person
Dead body of person.

I see the dead person just lying here.

* * *

>shoot person with gun
I shoot the person with my revolver, hitting him!
I damaged the zombie for 100 HP.
(Health: 0)

I can see a strange looking person here. He's lying on the pavement, pawing at something and making groaning noises.

I land a killing blow and the person falls to the ground!

>x deadman
You can't see any such thing.

>x person
You can't see any such thing.

>x person
You can't see any such thing.

>l
Parking Lot
I'm here in the parking lot in front of our small little apartment.

I can see a trainyard to the west and the town square to the east.

* * *

>l
Parking Lot
I'm here in the parking lot in front of our small little apartment.

I can see a trainyard to the west and the town square to the east.

You can see dead person here.

>nw
Parking Lot
I'm here in the parking lot in front of our small little apartment.

I can see a trainyard to the west and the town square to the east.

You can see dead person here.

>restart
Are you sure you want to restart?

* * *

>shoot person with gun
I shoot the person with my revolver, hitting him!
I damaged the zombie for 100 HP.
(Health: 0)

I can see a strange looking person here. He's lying on the pavement, pawing at something and making groaning noises.

I land a killing blow and the person falls to the ground!

>shoot person
That's not a verb I recognise.

* * *

>nw
Parking Lot
I'm here in the parking lot in front of our small little apartment.

I can see a trainyard to the west and the town square to the east.

I can see a strange looking person here. He's lying on the pavement, pawing at something and making groaning noises.

>x person
He's scary looking. I shouldn't get too close.

I can see a strange looking person here. He's lying on the pavement, pawing at something and making groaning noises.

>kill person
What do I attack the person with?

The strange looking person notices me and gets up, groaning and moaning. It's coming for me!

The strange looking person is groaning and moaning and is trying to kill me!
The strange looking person hits me really hard! Owieee…My health goes down by 15.
I have some cuts and bruises. Where's Mommy to help put on Band-aids?
I don't feel hungry at all right now! Let's go do something.
. (Health: 85)

>attack person with gun
The strange looking person is groaning and moaning and is trying to kill me!
The strange looking person hits me hard.
My health goes down by 8.
(Health: 77)

>shoot person with gun
I shoot the person with my revolver, hitting him!
I damaged the zombie for 100 HP.
(Health: 0)

The strange looking person is groaning and moaning and is trying to kill me!
The strange looking person hits me hard.
My health goes down by 5.
(Health: 72)

I land a killing blow and the person falls to the ground!

* * *

>nw
Parking Lot
I'm here in the parking lot in front of our small little apartment.

I can see a trainyard to the west and the town square to the east.

I can see a strange looking person here. He's lying on the pavement, pawing at something and making groaning noises.

>shoot revolver
I only understood you as far as wanting to shoot.

>shoot revolver with gun
I only understood you as far as wanting to shoot.

>shoot person with gun
I only understood you as far as wanting to shoot.

* * *

>nw
Parking Lot
I'm here in the parking lot in front of our small little apartment.

I can see a trainyard to the west and the town square to the east.

I can see a strange looking person here. He's lying on the pavement, pawing at something and making groaning noises.

>x revolver
With great power comes great responsibility, my Daddy always told me. I barely know how to shoot this thing.

I can see a strange looking person here. He's lying on the pavement, pawing at something and making groaning noises.

>shoot person with revolver
I shoot the person with my revolver, hitting him!
I damaged the zombie for 100 HP.
(Health: 0)

The strange looking person notices me and gets up, groaning and moaning. It's coming for me!

The strange looking person is groaning and moaning and is trying to kill me!
The strange looking person swings at me but I dodge it.

I land a killing blow and the person falls to the ground!

>x person
You can't see any such thing.

* * *

>nw
Parking Lot
I'm here in the parking lot in front of our small little apartment.

I can see a trainyard to the west and the town square to the east.

I can see a strange looking person here. He's lying on the pavement, pawing at something and making groaning noises.

>shoot person
What do you want to shoot Strange Looking Person with?

>gun
I shoot the person with my revolver, hitting him!
I damaged the zombie for 100 HP.
(Health: 0)

I can see a strange looking person here. He's lying on the pavement, pawing at something and making groaning noises.

I land a killing blow and the person falls to the ground!

>l
Parking Lot
I'm here in the parking lot in front of our small little apartment.

I can see a trainyard to the west and the town square to the east.

I see the dead person just lying here.

>l
Parking Lot
I'm here in the parking lot in front of our small little apartment.

I can see a trainyard to the west and the town square to the east.

You can see dead person here.

I see the dead person just lying here.

>l
Parking Lot
I'm here in the parking lot in front of our small little apartment.

I can see a trainyard to the west and the town square to the east.

You can see dead person here.

I see the dead person just lying here.

* * *

>gun
I shoot the person with my revolver, hitting him!
I damaged the zombie for 100 HP.
(Health: 0)

I can see a strange looking person here. He's lying on the pavement, pawing at something and making groaning noises.

I land a killing blow and the person falls to the ground!

>x person
You can't see any such thing.

>x dead person
You can't see any such thing.

* * *

>x person
Dead body of the disfigured person. Scary.

I see the dead person just lying here.

>x dead person
Dead body of the disfigured person. Scary.

I see the dead person just lying here.

* * *

>shoot person
What do you want to shoot Strange Looking Person with?

>revolver
I shoot the person with my revolver, hitting him!
I damaged the zombie for 100 HP.
(Health: 0)

I can see a strange looking person here. He's lying on the pavement, pawing at something and making groaning noises.

I land a killing blow and the person falls to the ground!

>l
Parking Lot
I'm here in the parking lot in front of our small little apartment.

I can see a trainyard to the west and the town square to the east.

I see the dead person just lying here.

>x person
You can't see any such thing.

>x dead person
Dead body of the disfigured person. Scary.

I see the dead person just lying here.