It's getting dark outside and Mommy and Daddy haven't been home for 2 months. There's strange, dead people walking around outside, making scary noises. I don't like it here. It is frightening. I've run out of food. I need to find a way out.

ANABELLE
An Interactive Fiction by Kai Wong
Release 1 / Serial number 130312 / Inform 7 build 6G60 (I6/v6.32 lib 6/12N) SD

Apartment Living Room
Our living room…or mine now, anyways. There's our couch in the corner, facing daddy's TV. A glass coffee table is next to the couch. Our large baywindow looks out to the street.

I can see our kitchen to the west and our bedroom to the south. Our door out is to the east.

>x walls
You can't see any such thing.

* * *

>w
Kitchen
Our small, little kitchen. Mommy always baked yummy chocolate chip cookies for me. There are some cupboards overhead. We have a sink, a refrigerator, a stove, and a floor mat.

I can see our living room to the east.

>open cupboards
It seems to be locked.

>look under mat
I find a key under the floor mat, which I bend down and pick up.

* * *

>unlock cupboards
(with the cupboard key)
I unlock the cupboards and open it.

>look in cupboards
In Cupboards are a case of 8 bullet(s) for Daddy's revolver and a revolver.

* * *

>x me
My name is Anabelle. I am 10 years old.
I'm wearing my favorite yellow shirt and blouse! My hair is in my favorite ponytail, as usual.

I feel perfectly fine, like being in a sunny field.
I don't feel hungry at all right now! Let's go do something.

(Health: 100)
(Hunger: 100)

* * *

>nw
Train
I'm standing on the train. It's derailed, but to the west the train engine car is still on. I look down at my feet and I can see the couple attaching the engine car to the rest of the derailed train.

I can see another train compartment to the east and the engine car to the west.

>w
Engine car
I'm standing on the engine car. I see a panel in the side of the car and a door going inside the engine room. I can see a window looking inside the room.

To the east I can see the train coupler.

>w
Engine Room
I'm inside the engine room. There's a dead man sitting on the chair here. On the wall is a panel full of switches and buttons.

The door to the engine car is to the east.

>put lever into slot
(Lever C into lever slot)
I put the lever C into the lever slot and flip it on!

>x lever b
Lever B is currently switched off.

>x lever a
Lever A is currently switched on.

>switch lever b
I switch the Lever B on. There's a satisfying clunk!

>press button
The train won't budge with the coupler still attached!

>e
Engine car
I'm standing on the engine car. I see a panel in the side of the car and a door going inside the engine room. I can see a window looking inside the room.

To the east I can see the train coupler.

>e
Train
I'm standing on the train. It's derailed, but to the west the train engine car is still on. I look down at my feet and I can see the couple attaching the engine car to the rest of the derailed train.

I can see another train compartment to the east and the engine car to the west.

>break train coupler with wrench
CRINK! The old rusty wrench breaks right in half!
The wrench is broken. I can't use it anymore!

>w
Engine car
I'm standing on the engine car. I see a panel in the side of the car and a door going inside the engine room. I can see a window looking inside the room.

To the east I can see the train coupler.

>e
Train
I'm standing on the train. It's derailed, but to the west the train engine car is still on. I look down at my feet and I can see the couple attaching the engine car to the rest of the derailed train.

I can see another train compartment to the east and the engine car to the west.

>brean train coupler with cable cutters
That's not a verb I recognise.

>break train coupler with cable cutters
MMMMMMMPH! Darn, I'm not strong enough to cut the coupler.

>break train coupler with spanner
MMMMMMMPH!

*snap!*

The train coupler slides apart! Hooooray!

>w
Engine car
I'm standing on the engine car. I see a panel in the side of the car and a door going inside the engine room. I can see a window looking inside the room.

To the east I can see the train coupler.

* * *

>w
Engine Room
I'm inside the engine room. There's a dead man sitting on the chair here. On the wall is a panel full of switches and buttons.

The door to the engine car is to the east.

>push button
Just as I press the button, the tall man from the store hops into the car with me! "Not so fast, little girl! You're giving me the controls to this thing. Now back off!"

You may have escaped from the town, but you have not escaped from the man.

    *** You have won ***

Would you like to RESTART, RESTORE a saved game, QUIT or UNDO the last command?

* * *

>put lever into slot
(Lever C into lever slot)
I put the lever C into the lever slot and flip it on!

>turn on lever b
I switch the Lever B on. There's a satisfying clunk!

>l
Engine Room
I'm inside the engine room. There's a dead man sitting on the chair here. On the wall is a panel full of switches and buttons.

The door to the engine car is to the east.

>x panel
The panel is covered with switches and buttons.

Lever A's light is turned off.

Lever B's light is turned on.

Lever C's light is turned off and the lever is missing from the slot.

There is a large red button that says "Start".

>turn on lever a
That's already on.

* * *

>w
Engine Room
I'm inside the engine room. There's a dead man sitting on the chair here. On the wall is a panel full of switches and buttons.

The door to the engine car is to the east.

>e
Engine car
I'm standing on the engine car. I see a panel in the side of the car and a door going inside the engine room. I can see a window looking inside the room.

To the east I can see the train coupler.

>go inside door
Engine Room
I'm inside the engine room. There's a dead man sitting on the chair here. On the wall is a panel full of switches and buttons.

The door to the engine car is to the east.

>push button
Just as I press the button, the tall man from the store hops into the car with me! "Not so fast, little girl! You're giving me the controls to this thing. Now back off!"

You may have escaped from the town, but you have not escaped from the man.

    *** You have won ***

Would you like to RESTART, RESTORE a saved game, QUIT or UNDO the last command?

* * *

>w
Engine Room
I'm inside the engine room. There's a dead man sitting on the chair here. On the wall is a panel full of switches and buttons.

The door to the engine car is to the east.

>press button
Just as I press the button, the tall man from the store hops into the car with me! "Not so fast, little girl! You're giving me the controls to this thing. Now back off!"

You may have escaped from the town, but you have not escaped from the man.

    *** You have won ***

Would you like to RESTART, RESTORE a saved game, QUIT or UNDO the last command?

* * *

>w
Engine Room
I'm inside the engine room. There's a dead man sitting on the chair here. On the wall is a panel full of switches and buttons.

The door to the engine car is to the east.

>push button
Just as I press the button, the tall man from the store hops into the car with me! "Hold on, little girl. Thanks for lending me this gun! I happen to know where these tracks go and I'll help you get to where you want to go!"

With the man's help, you steer the train to a future full of hope and happiness.

    *** You have won ***

Would you like to RESTART, RESTORE a saved game, QUIT or UNDO the last command?

* * *

>nw
Train
I'm standing on the train. It's derailed, but to the west the train engine car is still on. I look down at my feet and I can see the couple attaching the engine car to the rest of the derailed train.

I can see another train compartment to the east and the engine car to the west.

>e
Parking Lot
I'm here in the parking lot in front of our small little apartment.

I can see a trainyard to the east and the town square to the west.

There are zombies about!

>e
Trainyard
I'm here at the trainyard. I see a rail stretching into the distance. A train is on the rail to the north but it is derailed. I can see a small little shack off to the south.

I can see the parking lot west of here and the train to the north.

A zombie takes notice of me!

It's an old wrench, used many times.

>n
Train
I'm standing on the train. It's derailed, but to the west the train engine car is still on. I look down at my feet and I can see the couple attaching the engine car to the rest of the derailed train.

I can see another train compartment to the east and the engine car to the west.

It's an old wrench, used many times.

>w
Engine car
I'm standing on the engine car. I see a panel in the side of the car and a door going inside the engine room. I can see a window looking inside the room.

To the east I can see the train coupler.

It's an old wrench, used many times.

* * *

>n
Train
I'm standing on the train. It's derailed, but to the west the train engine car is still on. I look down at my feet and I can see the couple attaching the engine car to the rest of the derailed train.

I can see another train compartment to the east and the engine car to the west.

It's an old wrench, used many times.

>c coupler
That's not a verb I recognise.

>x coupler
It's twisted together in an ugly angle, a result of the rear train cars becoming derailed. Maybe I can somehow break this coupler apart.

>break couple with wrench
You can't see any such thing.

>break coupler with wrench
HA!

>i
I'm carrying: 
Old rusty wrench
Spanner
a water bottle
Lever C
an axe
pillowcase bag
bedsheets
Flashlight
2 pills
1 bandaids
a case of 8 bullet(s) for Daddy's revolver
a revolver
(Health: 100)

* * *

>nw
Train
I'm standing on the train. It's derailed, but to the west the train engine car is still on. I look down at my feet and I can see the couple attaching the engine car to the rest of the derailed train.

I can see another train compartment to the east and the engine car to the west.

>break coupler with spanner
MMMMMMMPH!

*snap!*

The train coupler slides apart! Hooooray!

>w
Engine car
I'm standing on the engine car. I see a panel in the side of the car and a door going inside the engine room. I can see a window looking inside the room.

To the east I can see the train coupler.

* * *

>w
Engine Room
I'm inside the engine room. There's a dead man sitting on the chair here. On the wall is a panel full of switches and buttons.

The door to the engine car is to the east.

>x panel
The panel is covered with switches and buttons.

Lever A's light is turned off.

Lever B's light is turned on.

Lever C's light is turned off and the lever is missing.

There is a large red button that says "Start".

>put lever into slot
I didn't understand that sentence.

>i
I'm carrying: 
Cable cutters
Old rusty wrench
Spanner
a water bottle
Lever C
an axe
pillowcase bag
bedsheets
Flashlight
2 pills
1 bandaids
a case of 8 bullet(s) for Daddy's revolver
a revolver
(Health: 100)

>put lever c into slot c
I didn't understand that sentence.

>put lever in slot
(Lever C in lever slot)
I put the lever C into the lever slot and flip it on!

* * *

>put lever into slot
(Lever C into lever slot)
I put the lever C into the lever slot and flip it on!

* * *

>nw
Train
I'm standing on the train. It's derailed, but to the west the train engine car is still on. I look down at my feet and I can see the couple attaching the engine car to the rest of the derailed train.

I can see another train compartment to the east and the engine car to the west.

>s
Trainyard
I'm here at the trainyard. I see a rail stretching into the distance. A train is on the rail to the north but it is derailed. I can see a small little shack off to the south.

I can see the parking lot west of here and the train to the north.

A zombie takes notice of me!

>w
Parking Lot
I'm here in the parking lot in front of our small little apartment.

I can see a trainyard to the east and the town square to the west.

There are zombies about!

>w
Town Square
I'm here at the town square. I see some zombies milling about.

To the south I can see a small house. To the west I can see a general store. The parking lot is back to the east. To the north I can see a hardware store.

There are zombies about!

>w
Front of the General Store
I'm standing in front of the town's small general store. Some of the letters on the sign are gone.

I see the Town Square to the east. The door to the general store is to the west.

>w
General Store.
I'm in the general store. The shelves have been knocked over and there are things strewn across the floor. There's a counter in the corner.

The exit is to the east.

I can see a tall man crouching behind one of the shelves.

>go through door
You can't see any such thing.

>x generalstoordoor
You can't see any such thing.

>x generalstoredoor
You can't see any such thing.

>x door
You can't see any such thing.

>l
Front of the General Store
I'm standing in front of the town's small general store. Some of the letters on the sign are gone.

I see the Town Square to the east. The door to the general store is to the west.

A zombie is groaning and moaning and is trying to kill me!

The zombie hits me hard.

My health goes down by 4.
(Health: 94)

>shoot zombie with gun
I shoot the person with my revolver, hitting him!
I damaged the zombie for 100 HP.
(Health: 0)

The zombie crumples to the ground.

>l
Front of the General Store
I'm standing in front of the town's small general store. Some of the letters on the sign are gone.

I see the Town Square to the east. The door to the general store is to the west.

There are zombies about!

>w
You can't go that way.

There are zombies about!

* * *

>w
General Store.
I'm in the general store. The shelves have been knocked over and there are things strewn across the floor. There's a counter in the corner.

The exit is to the east.

I can see a tall man crouching behind one of the shelves.

>x man
He's pretty tall. He's watching me carefully. He has no weapons so I don't think he can hurt me. He has a large bag with him.

I can: talk, ask, give.

>nw
Train
I'm standing on the train. It's derailed, but to the west the train engine car is still on. I look down at my feet and I can see the couple attaching the engine car to the rest of the derailed train.

I can see another train compartment to the east and the engine car to the west.

* * *

>s
Trainyard
I'm here at the trainyard. I see a rail stretching into the distance. A train is on the rail to the north but it is derailed. I can see a small little shack off to the south.

I can see the parking lot west of here and the train to the north.

A zombie takes notice of me!

>x dead zombie
I see some dead zombies lying around.

A zombie is groaning and moaning and is trying to kill me!

The zombie hits me hard.

My health goes down by 5.
(Health: 95)

* * *

>yes
That was a rhetorical question.

>nw
Train
I'm standing on the train. It's derailed, but to the west the train engine car is still on. I look down at my feet and I can see the couple attaching the engine car to the rest of the derailed train.

I can see another train compartment to the east and the engine car to the west.

* * *

>s
Trainyard
I'm here at the trainyard. I see a rail stretching into the distance. A train is on the rail to the north but it is derailed. I can see a small little shack off to the south.

I can see the parking lot west of here and the train to the north.

There are zombies about!

>w
Parking Lot
I'm here in the parking lot in front of our small little apartment.

I can see a trainyard to the east and the town square to the west.

There are zombies about!

* * *

>w
Town Square
I'm here at the town square. I see some zombies milling about.

To the south I can see a small house. To the west I can see a general store. The parking lot is back to the east. To the north I can see a hardware store.

There are zombies about!

>w
Front of the General Store
I'm standing in front of the town's small general store. Some of the letters on the sign are gone.

I see the Town Square to the east. The door to the general store is to the west.

A zombie takes notice of me!

>w
You can't go that way.

A zombie is groaning and moaning and is trying to kill me!

The zombie lunges at me but I dodge it.

>w
You can't go that way.

A zombie is groaning and moaning and is trying to kill me!

The zombie lunges at me but I dodge it.

>go into door
You can't see any such thing.

* * *

>x hands
You can't see any such thing.