It's getting dark outside and Mommy and Daddy haven't been home for 2 months. There's strange, dead people walking around outside, making scary noises. I don't like it here. It is frightening. I've run out of food. I need to find a way out.

ANABELLE
An Interactive Fiction by Kai Wong
Release 1 / Serial number 130305 / Inform 7 build 6G60 (I6/v6.32 lib 6/12N) SD

Apartment Living Room
Our living room…or mine now, anyways. There's our couch in the corner, facing daddy's TV. A glass coffee table is next to the couch. Our large baywindow looks out to the street.

I can see our kitchen to the west and our bedroom to the south. Our door out is to the east.

I beg your pardon?

* * *

>l
Apartment Living Room
Our living room…or mine now, anyways. There's our couch in the corner, facing daddy's TV where I watch Sesame Street. A glass coffee table is next to the couch. A large baywindow looks out to the street.

I can see our kitchen to the west and our bedroom to the south. Our door out is to the east.

* * *

>x baywindow
I look out our open window. I can see a form of something crawling down below on the street but I can't really tell what it is.

* * *

>e
As I walk to our front door, I hear scary noises coming from the other side. I don't want to go through there.

* * *

>nw
Engine Room
I'm inside the engine room. There's a dead man sitting on the chair here. On the wall is a panel full of switches and buttons.

The door to the engine car is to the east.

>take lever d
Taken.

>i
I'm carrying: 
the lever that the dead man is holding
an axe
pillowcase bag
bedsheets
2 pills
1 bandaids
a case of 8 bullet(s) for Daddy's revolver
a revolver
(Health: 100)

* * *

>take lever d
Taken.

>x lever c
I've taken this from the dead man. It looks like it can be put in the slot of Lever C.

>put lever c in slot
I put the lever C into the lever slot and flip it on!

>x lever c
I've taken this from the dead man. It looks like it can be put in the slot of Lever C.

>put lever c into slot
I didn't understand that sentence.

* * *

>nw
Engine Room
I'm inside the engine room. There's a dead man sitting on the chair here. On the wall is a panel full of switches and buttons.

The door to the engine car is to the east.

>x lever
Which do you mean, Lever A, Lever B or the lever that the dead man is holding?

>lever that the dead man is holding
It looks like it could fit in the slot of Lever C.

>take lever
Which do you mean, Lever A, Lever B or the lever that the dead man is holding?

>lever that the dead man is holding
Taken.

>put lever C into slot
I didn't understand that sentence.

* * *

>x lever
Which do you mean, Lever A, Lever B or the lever that the dead man is holding?

>x lever that the dead man is holding
You can't see any such thing.

>x lever
(the lever that the dead man is holding)
You see nothing special about the lever that the dead man is holding.

* * *

>x lever
Which do you mean, Lever A, Lever B or the lever that the dead man is holding?

>x leverD
It looks like it could fit in the slot of Lever C.

* * *

>x lever
Which do you mean, Lever A, Lever B or the lever that the dead man is holding?

>x dead man
Looks like he died here…it makes me too sad to think about. He's holding something in his hand.

>x man's hand
The dead man's hand is still grasping a lever.

>x lever
Which do you mean, Lever A, Lever B or LeverD?

* * *

>nw
Engine Room
I'm inside the engine room. There's a dead man sitting on the chair here. On the wall is a panel full of switches and buttons.

The door to the engine car is to the east.

>x lever that the dead man is holding
You can't see any such thing.

>nw
Engine Room
I'm inside the engine room. There's a dead man sitting on the chair here. On the wall is a panel full of switches and buttons.

The door to the engine car is to the east.

You can see the lever that the dead man is holding here.

>restart
Are you sure you want to restart?

* * *

>nw
Engine Room
I'm inside the engine room. There's a dead man sitting on the chair here. On the wall is a panel full of switches and buttons.

The door to the engine car is to the east.

>take lever D
Taken.

>i
I'm carrying: 
Lever C
an axe
pillowcase bag
bedsheets
2 pills
1 bandaids
a case of 8 bullet(s) for Daddy's revolver
a revolver
(Health: 100)

* * *

>take lever D
Taken.

>x lever c
I've taken this from the dead man. It looks like it can be put in the slot of Lever C.

Lever C is currently switched off.

* * *

>nw
Engine Room
I'm inside the engine room. There's a dead man sitting on the chair here. On the wall is a panel full of switches and buttons.

The door to the engine car is to the east.

>take lever
Which do you mean, Lever A, Lever B, the lever that the dead man is holding or Lever slot?

>x lever D
It looks like it can be put in the slot of Lever C.

>take lever D
Taken.

>put lever into slot
I didn't understand that sentence.

>put lever c in lever slot
I put the lever C into the lever slot and flip it on!

>x lever slot
You see nothing special about Lever slot.

* * *

>nw
Engine Room
I'm inside the engine room. There's a dead man sitting on the chair here. On the wall is a panel full of switches and buttons.

The door to the engine car is to the east.

>x man
Looks like he died here…it makes me too sad to think about. He's holding something in his hand.

>x hand
The dead man's hand is still grasping a lever.

>take lever
Which do you mean, Lever A, Lever B, the lever that the dead man is holding or Lever slot?

>lever that the dead man is holding
Taken.

>x lever
(Lever C)
It looks like it can be put in the slot of Lever C.

Lever C is currently switched off.

* * *

>nw
Engine Room
I'm inside the engine room. There's a dead man sitting on the chair here. On the wall is a panel full of switches and buttons.

The door to the engine car is to the east.

>x dead man
Looks like he died here…it makes me too sad to think about. He's holding something in his hand.

>x hand
The dead man's hand is still grasping a lever.

>x lever
Which do you mean, Lever A, Lever B, the lever that the dead man is holding or Lever slot?

>x lever that the dead man is holding
It looks like it can be put in the slot of Lever C.

>take lever
Which do you mean, Lever A, Lever B, the lever that the dead man is holding or Lever slot?

* * *

>x lever
Which do you mean, Lever A, Lever B, the lever that the dead man is holding or Lever slot?

>lever that the dead man is holding
You can't see any such thing.

>x lever that the dead man is holding
You can't see any such thing.

* * *

>nw
Engine Room
I'm inside the engine room. There's a dead man sitting on the chair here. On the wall is a panel full of switches and buttons.

The door to the engine car is to the east.

>x lever D
It looks like it could be put in the slot of Lever C.