It's getting dark outside and Mommy and Daddy haven't been home for 2 months. There's strange, dead people walking around outside, making scary noises. I don't like it here. It is frightening. I've run out of food. I need to find a way out.

ANABELLE
An Interactive Fiction by Kai Wong
Release 1 / Serial number 130311 / Inform 7 build 6G60 (I6/v6.32 lib 6/12N) SD

Apartment Living Room
Our living room…or mine now, anyways. There's our couch in the corner, facing daddy's TV. A glass coffee table is next to the couch. Our large baywindow looks out to the street.

I can see our kitchen to the west and our bedroom to the south. Our door out is to the east.

>s
Bedroom
Our cozy, little bedroom. Mommy and Daddy have a big bed in the middle of the room, with a nightstand next to it. Our small closet is in the wall.

I can see our living room to the north and our bathroom to the west.

* * *

>w
Bathroom
Our small bathroom. There's a toilet, a shower, a sink, and a medicine cabinet here.

I can see our bedroom to the east.

>open cabinet
I open the medicine cabinet. I can see some pain pills and a bandaid.

>take bandaid
You can't see any such thing.

>take bandaids
You can't see any such thing.

>x cabinet
When I get sick or have a boo boo, Daddy gets some medicine or Band-aids from here.

>x bandaids
You can't see any such thing.

>open cabinet
I open the medicine cabinet. I can see some pain pills and a bandaid.

>closer cabinet
That's not a verb I recognise.

>close cabinet
That's already closed.

* * *

>w
Bathroom
Our small bathroom. There's a toilet, a shower, a sink, and a medicine cabinet here.

I can see our bedroom to the east.

>open medicine cabinet
I open the medicine cabinet. I can see some pain pills and a bandaid.

You open Medicine cabinet, revealing 2 pills and 1 bandaids.

* * *

>s
Bedroom
Our cozy, little bedroom. Mommy and Daddy have a big bed in the middle of the room, with a nightstand next to it. Our small closet is in the wall.

I can see our living room to the north and our bathroom to the west.

>e
You can't go that way.

* * *

>w
Bathroom
Our small bathroom. There's a toilet, a shower, a sink, and a medicine cabinet here.

I can see our bedroom to the east.

>open medicine cabinet
You open Medicine cabinet, revealing 2 pills and 1 bandaids.

>take bandaids
Taken.

>put on bandaid
You can't see any such thing.

>put on bandaids
You can't see any such thing.

>x bandaid
Some bandaids if I get any boo-boos.

>put bandaid
(in 1 bandaids)

* * *

>nw
Town Square
I'm here at the town square. I see some zombies milling about.

To the south I can see a small house. To the west I can see a general store. The parking lot is back to the east. To the north I can see a hardware store.

There are zombies about!

>restart
Are you sure you want to restart?

* * *

>nw
Town Square
I'm here at the town square. I see some zombies milling about.

To the south I can see a small house. To the west I can see a general store. The parking lot is back to the east. To the north I can see a hardware store.

There are zombies about!

>n
Front of the Hardware Store
I'm standing in front of the town's hardware store. The doors and windows are all boarded up.

I see the Town Square to the west.

There are zombies about!

>n
Hardware Store
I'm in the hardware store. There are a lot of towering shelves here.

Shelf A is to the north. Shelf B is to the east. Shelf C is to the west. The door out is to the south.

>n
Shelf A
I'm standing in the aisle of shelf A.

I see the main room to the south.

I see a pair of strong cable cutters here.

* * *

>n
Hardware Store
I'm in the hardware store. There are a lot of towering shelves here.

Shelf A is to the north. Shelf B is to the east. Shelf C is to the west. The door out is to the south.

>e
Shelf B
I'm standing in the aisle of shelf B. I see the main room to the west.

Aieeee!

A zombie is groaning and moaning and is trying to kill me!

The zombie lunges at me but I dodge it.

>w
Hardware Store
I'm in the hardware store. There are a lot of towering shelves here.

Shelf A is to the north. Shelf B is to the east. Shelf C is to the west. The door out is to the south.

>w
Shelf C
I'm standing in the aisle of shelf C.

I see the main room to the south.

I see some batteries here!

>l
Shelf C
I'm standing in the aisle of shelf C.

I see the main room to the south.

>l
Shelf C
I'm standing in the aisle of shelf C.

I see the main room to the south.

>take batteries
I take the batteries and put it in my flashlight.

* * *

>w
Shelf C
I'm standing in the aisle of shelf C.

I see the main room to the south.

I see some batteries here!

>take batteries
I take the batteries and put it in my flashlight.

>x flashlight
Daddy's flashlight. He uses it to look under the sink.

Flashlight is currently switched off.

* * *

>shoot zombie with gun
I shoot the person with my revolver, hitting him!
I damaged the zombie for 100 HP.
(Health: 0)

The zombie crumples to the ground.

>l
Shelf B
I'm standing in the aisle of shelf B. I see the main room to the west.

>w
Hardware Store
I'm in the hardware store. There are a lot of towering shelves here.

Shelf A is to the north. Shelf B is to the east. Shelf C is to the west. The door out is to the south.

>e
Shelf B
I'm standing in the aisle of shelf B. I see the main room to the west.

>w
Hardware Store
I'm in the hardware store. There are a lot of towering shelves here.

Shelf A is to the north. Shelf B is to the east. Shelf C is to the west. The door out is to the south.

* * *

>e
Shelf B
I'm standing in the aisle of shelf B. I see the main room to the west.

Aieeee!

A zombie is groaning and moaning and is trying to kill me!

The zombie lunges at me but I dodge it.

>l
Shelf B
I'm standing in the aisle of shelf B. I see the main room to the west.

>l
Shelf B
I'm standing in the aisle of shelf B. I see the main room to the west.

* * *

>e
Shelf B
I'm standing in the aisle of shelf B. I see the main room to the west.

Aieeee!

A zombie is groaning and moaning and is trying to kill me!

The zombie lunges at me but I dodge it.

>x zombie
You can't see any such thing.

>x zombie
You can't see any such thing.

>l
Shelf B
I'm standing in the aisle of shelf B. I see the main room to the west.

* * *

>n
Hardware Store
I'm in the hardware store. There are a lot of towering shelves here.

Shelf A is to the north. Shelf B is to the east. Shelf C is to the west. The door out is to the south.

>w
Shelf C
I'm standing in the aisle of shelf C.

I see the main room to the south.

I see some batteries here!

>turn on flashlight
The flashlight doesn't have batteries…

>x me
My name is Anabelle. I am 10 years old.
I'm wearing my favorite yellow shirt and blouse! My hair is in my favorite ponytail, as usual.

I feel perfectly fine, like being in a sunny field.
I'm not hungry at all. Let's go do something!

(Health: 100)
(Hunger: 97)

>s
You can't go that way.

>e
Hardware Store
I'm in the hardware store. There are a lot of towering shelves here.

Shelf A is to the north. Shelf B is to the east. Shelf C is to the west. The door out is to the south.

>e
Shelf B
I'm standing in the aisle of shelf B. I see the main room to the west.

Aieeee!

A zombie is groaning and moaning and is trying to kill me!

The zombie hits me really hard! Owieee…

My health goes down by 15.
(Health: 85)

>l
Shelf B
I'm standing in the aisle of shelf B. I see the main room to the west.

A zombie is groaning and moaning and is trying to kill me!

The zombie hits me hard.

My health goes down by 3.
(Health: 82)

>l
Shelf B
I'm standing in the aisle of shelf B. I see the main room to the west.

A zombie is groaning and moaning and is trying to kill me!

The zombie lunges at me but I dodge it.

>l
Shelf B
I'm standing in the aisle of shelf B. I see the main room to the west.

A zombie is groaning and moaning and is trying to kill me!

The zombie hits me hard.

My health goes down by 4.
(Health: 78)

>l
Shelf B
I'm standing in the aisle of shelf B. I see the main room to the west.

A zombie is groaning and moaning and is trying to kill me!

The zombie lunges at me but I dodge it.

>l
Shelf B
I'm standing in the aisle of shelf B. I see the main room to the west.

A zombie is groaning and moaning and is trying to kill me!

The zombie hits me hard.

My health goes down by 4.
(Health: 74)

>l
Shelf B
I'm standing in the aisle of shelf B. I see the main room to the west.

A zombie is groaning and moaning and is trying to kill me!

The zombie hits me hard.

My health goes down by 10.
(Health: 64)

>l
Shelf B
I'm standing in the aisle of shelf B. I see the main room to the west.

A zombie is groaning and moaning and is trying to kill me!

The zombie hits me hard.

My health goes down by 8.
(Health: 56)

>l
Shelf B
I'm standing in the aisle of shelf B. I see the main room to the west.

A zombie is groaning and moaning and is trying to kill me!

The zombie hits me hard.

My health goes down by 4.
(Health: 52)

>x me
My name is Anabelle. I am 10 years old.
I'm wearing my favorite yellow shirt and blouse! My hair is in my favorite ponytail, as usual.

I don't feel too good.
Hmm, I haven't eaten in a small while. You know, I could really use some Oreos right now. I love the insides of them.

(Health: 52)
(Hunger: 79)

A zombie is groaning and moaning and is trying to kill me!

The zombie hits me hard.

My health goes down by 10.
(Health: 42)

>l
Shelf B
I'm standing in the aisle of shelf B. I see the main room to the west.

A zombie is groaning and moaning and is trying to kill me!

The zombie hits me hard.

My health goes down by 5.
(Health: 37)

>l
Shelf B
I'm standing in the aisle of shelf B. I see the main room to the west.

A zombie is groaning and moaning and is trying to kill me!

The zombie lunges at me but I dodge it.

>x me
My name is Anabelle. I am 10 years old.
I'm wearing my favorite yellow shirt and blouse! My hair is in my favorite ponytail, as usual.

I don't feel too good.
Hmm, I haven't eaten in a small while. You know, I could really use some Oreos right now. I love the insides of them.

(Health: 37)
(Hunger: 74)

A zombie is groaning and moaning and is trying to kill me!

The zombie hits me hard.

My health goes down by 8.
(Health: 29)

>l
Shelf B
I'm standing in the aisle of shelf B. I see the main room to the west.

A zombie is groaning and moaning and is trying to kill me!

The zombie hits me really hard! Owieee…

My health goes down by 11.
(Health: 18)

>l
Shelf B
I'm standing in the aisle of shelf B. I see the main room to the west.

A zombie is groaning and moaning and is trying to kill me!

The zombie hits me hard.

My health goes down by 5.
(Health: 13)

>l
Shelf B
I'm standing in the aisle of shelf B. I see the main room to the west.

A zombie is groaning and moaning and is trying to kill me!

The zombie hits me hard.

My health goes down by 1.
(Health: 12)

>x me
My name is Anabelle. I am 10 years old.
I'm wearing my favorite yellow shirt and blouse! My hair is in my favorite ponytail, as usual.

I don't feel well at all. My knees are shaking and I can't see clearly. Where's MommyMy stomach is starting to gurgle. I wonder what there is to eat?

(Health: 12)
(Hunger: 70)

A zombie is groaning and moaning and is trying to kill me!

The zombie hits me hard.

My health goes down by 9.
(Health: 3)

* * *

>w
Shelf C
I'm standing in the aisle of shelf C.

I see the main room to the south.

I see some batteries here!

>x batteries
Maybe these batteries can fit into my flashlight!

>x flashlight
Daddy's flashlight. He uses it to look under the sink.

Flashlight is currently switched off.

>take batteries
I take the batteries and put it in my flashlight.

>x flashlight
Daddy's flashlight. It now has batteries inside.

>turn on flashlight
The flashlight turns on!

>x flashlight
Daddy's flashlight. It now has batteries inside.

>restart
Are you sure you want to restart?

* * *

>n
Hardware Store
I'm in the hardware store. There are a lot of towering shelves here.

Shelf A is to the north. Shelf B is to the east. Shelf C is to the west. The door out is to the south.

>a
That's not a verb I recognise.

>n
Shelf A
I'm standing in the aisle of shelf A.

I see the main room to the south.

I see a pair of strong cable cutters here.

* * *

>n
Front of the Hardware Store
I'm standing in front of the town's hardware store. The doors and windows are all boarded up.

I see the Town Square to the west.

There are zombies about!

I beg your pardon?

>n
Hardware Store
I'm in the hardware store. There are a lot of towering shelves here.

Shelf A is to the north. Shelf B is to the east. Shelf C is to the west. The door out is to the south.

>e
Shelf B
I'm standing in the aisle of shelf B. I see the main room to the west.

* * *

>nw
Town Square
I'm here at the town square. I see some zombies milling about.

To the south I can see a small house. To the west I can see a general store. The parking lot is back to the east. To the north I can see a hardware store.

There are zombies about!

>put on bandaids
You can't see any such thing.

>x bandaid
You can't see any such thing.

>i
I'm carrying: 
a water bottle
Lever C
an axe
pillowcase bag
bedsheets
Flashlight
2 pills
1 bandaids
a case of 8 bullet(s) for Daddy's revolver
a revolver
(Health: 100)

There are zombies about!

>x bandaids
Some bandaids if I get any boo-boos.

There are zombies about!

* * *

>nw
Town Square
I'm here at the town square. I see some zombies milling about.

To the south I can see a small house. To the west I can see a general store. The parking lot is back to the east. To the north I can see a hardware store.

There are zombies about!

>put on bandaid
You can't see any such thing.

>x bandaid
Some bandaids if I get any boo-boos.

There are zombies about!

>put bandaid
What do you want to put 1 bandaids in?

>myself
A zombie takes notice of me!

* * *

I beg your pardon?